hs2_code,hs2_name,hs4_code,hs4_name,hs8_count,i,e,ie
1 ,第1章   活动物,101,马、驴、骡,5,99386178,76795,99462973
1 ,第1章   活动物,102,牛,6,3764935260,232566006,3997501266
1 ,第1章   活动物,103,猪,4,75302832,1851314122,1926616954
1 ,第1章   活动物,104,绵羊、山羊,4,20758190,737368,21495558
1 ,第1章   活动物,105,家禽，即鸡、鸭、鹅、火鸡及珍珠鸡,17,108684928,7379681,116064609
1 ,第1章   活动物,106,其他活动物,34,143299723,152731049,296030772
2 ,第2章   肉及食用杂碎,201,鲜、冷牛肉,3,3377000077,0,3377000077
2 ,第2章   肉及食用杂碎,202,冻牛肉,3,82397488618,3098912,82400587530
2 ,第2章   肉及食用杂碎,203,鲜、冷、冻猪肉,8,16462238530,737980550,17200219080
2 ,第2章   肉及食用杂碎,204,鲜、冷、冻绵羊肉或山羊肉,9,10649734571,74510733,10724245304
2 ,第2章   肉及食用杂碎,205,鲜、冷、冻马、驴、骡肉,1,13693748,20782450,34476198
2 ,第2章   肉及食用杂碎,206,鲜、冷、冻牛、猪、绵羊、山羊、马、驴、骡的食用杂碎,9,13980982352,4326304,13985308656
2 ,第2章   肉及食用杂碎,207,品目0105所列家禽的鲜、冷、冻肉及食用杂碎,26,20285977299,3640119888,23926097187
2 ,第2章   肉及食用杂碎,208,其他鲜、冷、冻肉及食用杂碎,9,95643770,212854259,308498029
2 ,第2章   肉及食用杂碎,209,未炼制或用其他方法提取的不带瘦肉的肥猪肉、猪脂肪及家禽脂肪，鲜、冷、冻、干、熏、盐腌或盐渍的,2,64307110,0,64307110
2 ,第2章   肉及食用杂碎,210,肉及食用杂碎，干、熏、盐腌或盐渍的；可供食用的肉或杂碎的细粉、粗粉,9,216856673,20434231,237290904
3 ,第3章   鱼、甲壳动物、软体动物及其他水生无脊椎动物,301,活鱼,20,1410734022,4042073725,5452807747
3 ,第3章   鱼、甲壳动物、软体动物及其他水生无脊椎动物,302,鲜、冷鱼，但品目03.04的鱼片及其他鱼肉除外,52,4347400306,1305062332,5652462638
3 ,第3章   鱼、甲壳动物、软体动物及其他水生无脊椎动物,303,冻鱼，但品目03.04的鱼片及其他鱼肉除外,51,22695382363,10896134244,33591516607
3 ,第3章   鱼、甲壳动物、软体动物及其他水生无脊椎动物,304,鲜、冷、冻鱼片及其他鱼肉（不论是否绞碎）,50,3834301229,18759405745,22593706974
3 ,第3章   鱼、甲壳动物、软体动物及其他水生无脊椎动物,305,干、盐腌或盐渍的鱼； 熏鱼，不论在熏制前或熏制过程中是否烹煮,28,1147176669,1925435891,3072612560
3 ,第3章   鱼、甲壳动物、软体动物及其他水生无脊椎动物,306,活、鲜、冷、冻、干、盐腌、盐渍、熏制的带壳或去壳甲壳动物；蒸过或用水煮过的带壳甲壳动物,38,44666500438,3434643571,48101144009
3 ,第3章   鱼、甲壳动物、软体动物及其他水生无脊椎动物,307,活、鲜、冷、冻、干、盐腌、盐渍、熏制的带壳或去壳软体动物,44,8790301280,17154292812,25944594092
3 ,第3章   鱼、甲壳动物、软体动物及其他水生无脊椎动物,308,不属于甲壳动物及软体动物的水生无脊椎动物，活、鲜、冷、冻、干、盐腌或盐渍、熏制的,15,434385795,342475006,776860801
3 ,第3章   鱼、甲壳动物、软体动物及其他水生无脊椎动物,309,适合供人食用的鱼、甲壳动物、软体动物和其他水生无脊椎动物的细粉、粗粉及团粒,2,10113903,95030078,105143981
4 ,第4章   乳品；蛋品；天然蜂蜜；其他食用动物产品,401,未浓缩及未加糖或其他甜物质的乳及稀奶油,4,7809202152,111745477,7920947629
4 ,第4章   乳品；蛋品；天然蜂蜜；其他食用动物产品,402,浓缩、加糖或其他甜物质的乳及稀奶油,5,24082477051,125012483,24207489534
4 ,第4章   乳品；蛋品；天然蜂蜜；其他食用动物产品,403,酸乳；酪乳、结块的乳及稀奶油、酸乳酒及其他发酵或酸化的乳和稀奶油，不论是否浓缩、加糖、加其他甜物质、加香料、加水果、加坚果或加可可,3,246583506,66044996,312628502
4 ,第4章   乳品；蛋品；天然蜂蜜；其他食用动物产品,404,乳清，不论是否浓缩、加糖或其他甜物质；其他品目未列名的含天然乳的产品，不论是否加糖或其他甜物质,2,4604464913,4828491,4609293404
4 ,第4章   乳品；蛋品；天然蜂蜜；其他食用动物产品,405,黄油及其他从乳提取的脂和油；乳酱,3,4650970612,46259829,4697230441
4 ,第4章   乳品；蛋品；天然蜂蜜；其他食用动物产品,406,乳酪及凝乳,5,3862837361,5684172,3868521533
4 ,第4章   乳品；蛋品；天然蜂蜜；其他食用动物产品,407,带壳禽蛋，鲜、腌制或煮过的,7,0,1242343305,1242343305
4 ,第4章   乳品；蛋品；天然蜂蜜；其他食用动物产品,408,去壳禽蛋及蛋黄，鲜、干、冻、蒸过或水煮、制成形或用其他方法保藏的，不论是否加糖或其他甜物质,4,117500,206232114,206349614
4 ,第4章   乳品；蛋品；天然蜂蜜；其他食用动物产品,409,天然蜂蜜,1,375210144,1390581134,1765791278
4 ,第4章   乳品；蛋品；天然蜂蜜；其他食用动物产品,410,其他品目未列名的昆虫及其他食用动物产品,7,3453493280,314991787,3768485067
5 ,第5章   其他动物产品,501,未经加工的人发，不论是否洗涤；废人发,1,0,3369630,3369630
5 ,第5章   其他动物产品,502,猪鬃、猪毛；獾毛及其他制刷用兽毛；上述鬃毛的废料,7,13418,322861340,322874758
5 ,第5章   其他动物产品,504,整个或切块的动物（鱼除外）的肠、膀胱及胃，鲜、冷、冻、干、熏、盐腌及盐渍的,8,4229676999,4652551135,8882228134
5 ,第5章   其他动物产品,505,带有羽毛或羽绒的鸟皮及鸟体其他部分；羽毛及不完整羽毛（不论是否修边）、羽绒，仅经洗涤、消毒或为了保藏而作过处理，但未经进一步加工；羽毛或不完整羽毛的粉末及废料,3,905007830,4466507036,5371514866
5 ,第5章   其他动物产品,506,骨及角柱，未经加工或经脱脂、简单整理（但未切割成形）、酸处理或脱胶；上述产品的粉末及废料,4,107826819,1164,107827983
5 ,第5章   其他动物产品,507,兽牙、龟壳、鲸须、鲸须毛、角、鹿角、蹄、甲、爪及喙，未经加工或仅简单整理但未切割成形；上述产品的粉末及废料,4,454652983,99658787,554311770
5 ,第5章   其他动物产品,508,珊瑚及类似品，未经加工或仅简单整理但未经进一步加工；软体动物壳、甲壳动物壳、棘皮动物壳、墨鱼骨，未经加工或仅简单整理但未切割成形，上述壳、骨的粉末及废料,2,107601488,46901682,154503170
5 ,第5章   其他动物产品,510,龙涎香、海狸香、灵猫香及麝香；斑蝥；胆汁，不论是否干制；供配制药用的腺体及其他动物产品，鲜、冷、冻或用其他方法暂时保藏的,5,124895753,16544115,141439868
5 ,第5章   其他动物产品,511,未列名的动物产品；不适合供人食用的第1或第3章的死动物,9,734236448,764539791,1498776239
6 ,第6章   活树及其他活植物；鳞茎、根及类似品；插花及装饰用簇叶,601,鳞茎、块茎、块根、球茎、根颈及根茎，休眠、生长或开花的；菊苣植物及其根，但品目12.12的根除外,6,596336934,13404535,609741469
6 ,第6章   活树及其他活植物；鳞茎、根及类似品；插花及装饰用簇叶,602,其他活植物（包括其根）、插枝及接穗；蘑菇菌丝,14,211546020,1555597966,1767143986
6 ,第6章   活树及其他活植物；鳞茎、根及类似品；插花及装饰用簇叶,603,制花束或装饰用的插花及花蕾，鲜、干、染色、漂白、浸渍或用其他方法处理的,7,256827602,781035663,1037863265
6 ,第6章   活树及其他活植物；鳞茎、根及类似品；插花及装饰用簇叶,604,制花束或装饰用的不带花及花蕾的植物枝、叶或其他部分、草、苔藓及地衣，鲜、干、染色、漂白、浸渍或用其他方法处理的,4,47992842,390244751,438237593
7 ,第7章   食用蔬菜、根及块茎,701,鲜或冷藏的马铃薯,2,0,1050346223,1050346223
7 ,第7章   食用蔬菜、根及块茎,702,鲜或冷藏的番茄,1,0,1732465939,1732465939
7 ,第7章   食用蔬菜、根及块茎,703,鲜或冷藏洋葱、青葱、大蒜、韭葱及其他葱属蔬菜,8,10380914,11275468475,11285849389
7 ,第7章   食用蔬菜、根及块茎,704,鲜或冷藏的卷心菜、菜花、球茎甘蓝、羽毛甘蓝及类似的实用芥菜类蔬菜,5,0,3650534986,3650534986
7 ,第7章   食用蔬菜、根及块茎,705,鲜或冷藏的莴苣及菊苣,4,0,1228797150,1228797150
7 ,第7章   食用蔬菜、根及块茎,706,鲜或冷藏的胡萝卜、芜菁、色拉甜菜根、婆罗门参、块根芹、萝卜及类似的食用根茎,2,0,2975518773,2975518773
7 ,第7章   食用蔬菜、根及块茎,707,鲜或冷藏的黄瓜及小黄瓜,1,0,248490263,248490263
7 ,第7章   食用蔬菜、根及块茎,708,鲜或冷藏的豆类蔬菜，不论是否脱荚,3,0,835641223,835641223
7 ,第7章   食用蔬菜、根及块茎,709,鲜或冷藏的其他蔬菜,22,298403502,6158424724,6456828226
7 ,第7章   食用蔬菜、根及块茎,710,冷冻蔬菜（不论是否蒸煮）,13,182412071,6498681013,6681093084
7 ,第7章   食用蔬菜、根及块茎,711,暂时保藏的蔬菜，但不适于直接食用,12,14881655,746042166,760923821
7 ,第7章   食用蔬菜、根及块茎,712,干蔬菜，整个、切块、切片、破碎或制成粉状，但未经进一步加工的,16,71680464,9399029015,9470709479
7 ,第7章   食用蔬菜、根及块茎,713,脱荚的干豆，不论是否去皮或分瓣,21,8743417114,1643279969,10386697083
7 ,第7章   食用蔬菜、根及块茎,714,鲜、冷、冻或干的木薯、竹竿、兰科植物块茎、菊芋、甘薯及含有高淀粉或菊粉的类似根茎，不论是否切片或制成团粒；西谷茎髓,14,11595937989,762790168,12358728157
8 ,第8章   食用水果及坚果；甜瓜或柑橘属水果的果皮,801,鲜或干的椰子、巴西果及腰果，不论是否去壳或去皮,8,4340160788,12693203,4352853991
8 ,第8章   食用水果及坚果；甜瓜或柑橘属水果的果皮,802,鲜或干的其他坚果，不论是否去壳或去皮,21,6257528448,3687001408,9944529856
8 ,第8章   食用水果及坚果；甜瓜或柑橘属水果的果皮,803,鲜或干的香蕉，包括芭蕉,2,6156586419,111842248,6268428667
8 ,第8章   食用水果及坚果；甜瓜或柑橘属水果的果皮,804,鲜或干的椰枣、无花果、菠萝、鳄梨、番石榴、芒果及山竹果,7,5817670633,439199563,6256870196
8 ,第8章   食用水果及坚果；甜瓜或柑橘属水果的果皮,805,鲜或干的柑桔属水果,8,2759438301,3739218466,6498656767
8 ,第8章   食用水果及坚果；甜瓜或柑橘属水果的果皮,806,鲜或干的葡萄,2,3482535225,3029344478,6511879703
8 ,第8章   食用水果及坚果；甜瓜或柑橘属水果的果皮,807,鲜的甜瓜（包括西瓜）及番木瓜,5,88771636,1035030209,1123801845
8 ,第8章   食用水果及坚果；甜瓜或柑橘属水果的果皮,808,鲜的苹果、梨及???,5,1456271293,6828566722,8284838015
8 ,第8章   食用水果及坚果；甜瓜或柑橘属水果的果皮,809,鲜的杏、樱桃、桃（包括油桃）、李及黑刺李,5,16559146307,921275990,17480422297
8 ,第8章   食用水果及坚果；甜瓜或柑橘属水果的果皮,810,其他鲜果,15,32724776781,1146473391,33871250172
8 ,第8章   食用水果及坚果；甜瓜或柑橘属水果的果皮,811,冷冻水果及坚果，不论是否蒸煮，加糖或其他甜物质,4,4970928253,1029115049,6000043302
8 ,第8章   食用水果及坚果；甜瓜或柑橘属水果的果皮,812,暂时保藏的水果及坚果，但不适于直接食用的,2,19244759,112182008,131426767
8 ,第8章   食用水果及坚果；甜瓜或柑橘属水果的果皮,813,品目0801至0806以外的干果；本章的什锦坚果或干果,9,1256904218,1218947932,2475852150
8 ,第8章   食用水果及坚果；甜瓜或柑橘属水果的果皮,814,柑桔属水果或甜瓜（包括西瓜）的果皮，鲜、冻、干或用盐水、亚硫酸水或其他防腐液暂时保藏的,1,12197689,30419581,42617270
9 ,第9章   咖啡、茶、马黛茶及调味香料,901,咖啡，不论是否焙炒或浸除咖啡碱；咖啡豆荚及咖啡豆皮；含咖啡的咖啡代用品,6,3497073090,1296452852,4793525942
9 ,第9章   咖啡、茶、马黛茶及调味香料,902,茶，不论是否加香料,12,697170096,10150083784,10847253880
9 ,第9章   咖啡、茶、马黛茶及调味香料,903,马黛茶,1,2721496,0,2721496
9 ,第9章   咖啡、茶、马黛茶及调味香料,904,胡椒；辣椒干及辣椒粉,4,1827624916,3448815468,5276440384
9 ,第9章   咖啡、茶、马黛茶及调味香料,905,香子兰豆,2,6175391,0,6175391
9 ,第9章   咖啡、茶、马黛茶及调味香料,906,肉桂及肉桂花,3,16504847,1333605747,1350110594
9 ,第9章   咖啡、茶、马黛茶及调味香料,907,丁香（母丁香、公丁香及丁香梗）,2,29862292,29717190,59579482
9 ,第9章   咖啡、茶、马黛茶及调味香料,908,肉豆蔻、肉豆蔻衣及豆蔻,6,561325058,3352171,564677229
9 ,第9章   咖啡、茶、马黛茶及调味香料,909,茴芹子、八角茴香、小茴香子、芫荽子、枯茗子及艹页蒿子；杜松果,8,616762849,447628179,1064391028
9 ,第9章   咖啡、茶、马黛茶及调味香料,910,姜、番红花、姜黄、麝香草、月桂叶、咖喱及其他调味香料,6,275459591,2053658150,2329117741
10 ,第10章  谷物,1001,小麦及混合麦,4,15773473356,15369028,15788842384
10 ,第10章  谷物,1002,黑麦,2,0,0,0
10 ,第10章  谷物,1003,大麦,2,9779235591,136739,9779372330
10 ,第10章  谷物,1004,燕麦,2,601056757,327321,601384078
10 ,第10章  谷物,1005,玉米,2,40731307704,7001891,40738309595
10 ,第10章  谷物,1006,稻谷、大米,10,13550248121,4904221481,18454469602
10 ,第10章  谷物,1007,食用高粱,2,21537353225,14433442,21551786667
10 ,第10章  谷物,1008,荞麦、谷子及加那利草子；其他谷物,12,117951444,117845115,235796559
11 ,第11章  制粉工业产品；麦芽；淀粉；菊粉；面筋,1101,小麦或混合麦的细粉,1,239002066,320636336,559638402
11 ,第11章  制粉工业产品；麦芽；淀粉；菊粉；面筋,1102,其他谷物细粉，但小麦或混合麦的细粉除外,4,189950522,10637447,200587969
11 ,第11章  制粉工业产品；麦芽；淀粉；菊粉；面筋,1103,谷物的粗粒、粗粉及团粒,8,4195454,1404129,5599583
11 ,第11章  制粉工业产品；麦芽；淀粉；菊粉；面筋,1104,经其他加工的谷物（例如，去壳、滚压、制片、制成粒状、切片或粗磨），但品目1006的稻谷、大米除外；谷物胚芽，整粒、滚压、制片或磨碎的,8,457035128,305992519,763027647
11 ,第11章  制粉工业产品；麦芽；淀粉；菊粉；面筋,1105,马铃薯的细粉、粗粉、粉末、粉片、颗粒及团粒,2,84358314,2769323,87127637
11 ,第11章  制粉工业产品；麦芽；淀粉；菊粉；面筋,1106,用品目0713的干豆或0714的西谷茎髓及植物根茎、块茎制成的细粉、粗粉及粉末；用第八章产品制成的细粉、粗粉及粉末,3,44498818,115210718,159709536
11 ,第11章  制粉工业产品；麦芽；淀粉；菊粉；面筋,1107,麦芽，不论是否焙制,2,45255782,1160434757,1205690539
11 ,第11章  制粉工业产品；麦芽；淀粉；菊粉；面筋,1108,淀粉；菊粉,6,11107125266,1177817261,12284942527
11 ,第11章  制粉工业产品；麦芽；淀粉；菊粉；面筋,1109,面筋，不论是否干制,1,9755955,1899308729,1909064684
12 ,第12章  含油子仁及果实；杂项子仁及果仁；工业用或药用植物；稻草、秸秆及饲料,1201,大豆，不论是否破碎,6,3.04466E+11,604912486,3.0507E+11
12 ,第12章  含油子仁及果实；杂项子仁及果仁；工业用或药用植物；稻草、秸秆及饲料,1202,未焙炒或未烹煮的花生，不论是否去壳或破碎,3,3614187248,763016184,4377203432
12 ,第12章  含油子仁及果实；杂项子仁及果仁；工业用或药用植物；稻草、秸秆及饲料,1203,干椰子肉,1,2005,0,2005
12 ,第12章  含油子仁及果实；杂项子仁及果仁；工业用或药用植物；稻草、秸秆及饲料,1204,亚麻子，不论是否破碎,1,1996060236,6501802,2002562038
12 ,第12章  含油子仁及果实；杂项子仁及果仁；工业用或药用植物；稻草、秸秆及饲料,1205,油菜子，不论是否破碎,4,4662394509,6872223,4669266732
12 ,第12章  含油子仁及果实；杂项子仁及果仁；工业用或药用植物；稻草、秸秆及饲料,1206,葵花子，不论是否破碎,2,534148668,3104405309,3638553977
12 ,第12章  含油子仁及果实；杂项子仁及果仁；工业用或药用植物；稻草、秸秆及饲料,1207,其他含油子仁及果实，不论是否破碎,20,9771700589,1192705147,10964405736
12 ,第12章  含油子仁及果实；杂项子仁及果仁；工业用或药用植物；稻草、秸秆及饲料,1208,含油子仁或果实的细粉及粗粉，但芥子粉除外,2,106083,296054288,296160371
12 ,第12章  含油子仁及果实；杂项子仁及果仁；工业用或药用植物；稻草、秸秆及饲料,1209,种植用的种子、果实及孢子,11,2778474170,624722877,3403197047
12 ,第12章  含油子仁及果实；杂项子仁及果仁；工业用或药用植物；稻草、秸秆及饲料,1210,鲜或干的啤酒花，不论是否研磨或制成团粒；蛇麻腺,2,256485829,2042959,258528788
12 ,第12章  含油子仁及果实；杂项子仁及果仁；工业用或药用植物；稻草、秸秆及饲料,1211,主要用作香料、药料、杀虫、杀菌或类似用途的植物或这些植物的某部分（包括子仁及果实），鲜、冷、冻或干的，不论是否切割、压碎或研磨成粉,41,1316939402,4692849968,6009789370
12 ,第12章  含油子仁及果实；杂项子仁及果仁；工业用或药用植物；稻草、秸秆及饲料,1212,鲜、冷、冻或干的刺槐豆、海草及其他藻类、甜菜及甘蔗，不论是否碾磨；主要供人使用的其他品目未列名的果核、果仁及植物产品（包括未焙制的菊苣根）,26,4077944870,3263541749,7341486619
12 ,第12章  含油子仁及果实；杂项子仁及果仁；工业用或药用植物；稻草、秸秆及饲料,1213,未经处理的谷类植物的茎、秆及谷壳，不论是否切碎、碾磨、挤压或制成团粒,1,46244738,24860750,71105488
12 ,第12章  含油子仁及果实；杂项子仁及果仁；工业用或药用植物；稻草、秸秆及饲料,1214,芜菁甘蓝、饲料甜菜、饲料用根、干草、紫苜蓿、三叶草、驴喜豆、羽衣甘蓝、羽扇豆、巢菜及类似饲料，不论是否制成团粒,2,4406452525,7282894,4413735419
13 ,第13章  虫胶；树胶、树脂及其他植物液、汁,1301,虫胶；天然树胶、树脂、树胶脂及油树脂（例如，香树脂）,6,281492451,69194273,350686724
13 ,第13章  虫胶；树胶、树脂及其他植物液、汁,1302,植物液汁及浸膏；果胶、果胶酸盐及果胶酸脂；从植物产品制得的琼脂、其他胶液及增稠剂，不论是否改性,16,2377824439,13418200924,15796025363
14 ,第14章  编结用植物材料；其他植物产品,1401,主要作编结用的植物材料（例如，竹子、藤、芦苇、灯芯草、柳条、酒椰叶，已净、漂白或染色的谷类植物的茎秆，椴树皮）,7,105657457,553016110,658673567
14 ,第14章  编结用植物材料；其他植物产品,1404,其他编码未列名的植物产品,3,953377542,721171491,1674549033
15 ,第15章  动、植物或微生物油、脂及其分解产品；精制的食用油脂；动、植物蜡,1501,猪脂肪（包括已炼制的猪油）及家禽脂肪，但品目0209及1503的货品除外,3,1023,6461581,6462604
15 ,第15章  动、植物或微生物油、脂及其分解产品；精制的食用油脂；动、植物蜡,1502,牛、羊脂肪，但品目1503的货品除外,2,441760446,9762639,451523085
15 ,第15章  动、植物或微生物油、脂及其分解产品；精制的食用油脂；动、植物蜡,1503,猪油硬脂、液体猪油、油硬脂、食用或非食用脂油，未经乳化、混合或其他方法制作,1,0,0,0
15 ,第15章  动、植物或微生物油、脂及其分解产品；精制的食用油脂；动、植物蜡,1504,鱼或海生哺乳动物的油、脂及其分离品，不论是否精制、但未经化学改性,3,1759519364,1125671736,2885191100
15 ,第15章  动、植物或微生物油、脂及其分解产品；精制的食用油脂；动、植物蜡,1505,羊毛脂及从羊毛脂制得的脂肪物质（包括纯净的羊毛脂）,1,432463,361339339,361771802
15 ,第15章  动、植物或微生物油、脂及其分解产品；精制的食用油脂；动、植物蜡,1506,其他动物油、脂及其分离品，不论是否精制，但未经化学改性,1,76253417,9140981,85394398
15 ,第15章  动、植物或微生物油、脂及其分解产品；精制的食用油脂；动、植物蜡,1507,豆油及其分离品，不论是否精制，但未经化学改性,2,2044169761,852534452,2896704213
15 ,第15章  动、植物或微生物油、脂及其分解产品；精制的食用油脂；动、植物蜡,1508,花生油及其分离品，不论是否精制，但未经化学改性,2,1712504298,132394980,1844899278
15 ,第15章  动、植物或微生物油、脂及其分解产品；精制的食用油脂；动、植物蜡,1509,油橄榄油及其分离品，不论是否精制，但未经化学改性,4,958818049,12535266,971353315
15 ,第15章  动、植物或微生物油、脂及其分解产品；精制的食用油脂；动、植物蜡,1510,其他橄榄油及其分离品，不论是否精制，但未经化学改性，包括掺有品目15.09的油或分离品的混合物,2,39274282,272836,39547118
15 ,第15章  动、植物或微生物油、脂及其分解产品；精制的食用油脂；动、植物蜡,1511,棕榈油及其分离品，不论是否精制，但未经化学改性,4,23805988377,106751678,23912740055
15 ,第15章  动、植物或微生物油、脂及其分解产品；精制的食用油脂；动、植物蜡,1512,葵花油、红花油、棉子油及其分离品，不论是否精制，但未经化学改性,4,2699105749,138349027,2837454776
15 ,第15章  动、植物或微生物油、脂及其分解产品；精制的食用油脂；动、植物蜡,1513,椰子油、棕榈仁油或巴巴苏棕榈果油及其分离品，不论是否精制，但未经化学改性,4,6025626974,758150,6026385124
15 ,第15章  动、植物或微生物油、脂及其分解产品；精制的食用油脂；动、植物蜡,1514,菜子油或芥子油及其分离品，不论是否精制，但未经化学改性,5,7458041470,34204087,7492245557
15 ,第15章  动、植物或微生物油、脂及其分解产品；精制的食用油脂；动、植物蜡,1515,其他固定植物或微生物油、脂（包括希蒙得木油）及其分离品，不论是否精制，但未经化学改性,12,3746047244,1070923376,4816970620
15 ,第15章  动、植物或微生物油、脂及其分解产品；精制的食用油脂；动、植物蜡,1516,动、植物或微生物油、脂及其分离品，全部或部分氢化、相互酯化、再酯化或反油酸化，不论是否精制，但未经进一步加工,3,3951208232,2250118660,6201326892
15 ,第15章  动、植物或微生物油、脂及其分解产品；精制的食用油脂；动、植物蜡,1517,人造黄油；本章各种动、植物或微生物油、脂及其分离品混合制成的食用油、脂或制品，但品目1516的食用油、脂及其分离品除外,3,7177496885,185762971,7363259856
15 ,第15章  动、植物或微生物油、脂及其分解产品；精制的食用油脂；动、植物蜡,1518,动、植物或微生物油、脂及其分离品，经过熟炼、氧化、脱水、硫化、吹制或在真空、惰性气体中加热聚合及用其他化学方法改性的，但品目15.16的产品除外；本章各种油、脂及其分离品混合制成的其他品目未列名的非食用油、脂或制品,1,283704259,12335593922,12619298181
15 ,第15章  动、植物或微生物油、脂及其分解产品；精制的食用油脂；动、植物蜡,1520,粗甘油；甘油水及甘油碱液,1,5135269316,37371,5135306687
15 ,第15章  动、植物或微生物油、脂及其分解产品；精制的食用油脂；动、植物蜡,1521,植物蜡（甘油三酸酯除外）、蜂蜡、其他虫蜡及鲸蜡，不论是否精炼或着色,3,136340782,286552607,422893389
15 ,第15章  动、植物或微生物油、脂及其分解产品；精制的食用油脂；动、植物蜡,1522,油鞣回收脂；加工处理油脂物质及动、植物蜡所剩的残渣,1,0,5052650,5052650
16 ,第16章  肉、鱼、甲壳动物、软体动物及其他水生无脊椎动物、昆虫的制品,1601,肉、食用杂碎、动物血或昆虫制成的香肠及类似产品；用香肠制成的食品,3,22394110,488123105,510517215
16 ,第16章  肉、鱼、甲壳动物、软体动物及其他水生无脊椎动物、昆虫的制品,1602,其他方法制作或保藏的肉、食用杂碎或动物血或昆虫,18,15718719,8936331481,8952050200
16 ,第16章  肉、鱼、甲壳动物、软体动物及其他水生无脊椎动物、昆虫的制品,1603,肉、鱼、甲壳动物、软体动物或其他水生无脊椎动物的精及汁,1,5574308,118579482,124153790
16 ,第16章  肉、鱼、甲壳动物、软体动物及其他水生无脊椎动物、昆虫的制品,1604,制作或保藏的鱼；鲟鱼子酱及鱼卵制的鲟鱼子酱代用品,19,561737610,23190361071,23752098681
16 ,第16章  肉、鱼、甲壳动物、软体动物及其他水生无脊椎动物、昆虫的制品,1605,制作或保藏的甲壳动物、软体动物及其他水生无脊椎动物,21,1023366416,26094607029,27117973445
17 ,第17章  糖及糖食,1701,固体甘蔗糖、甜菜糖及化学纯蔗糖,7,11232623658,543198550,11775822208
17 ,第17章  糖及糖食,1702,其他固体糖，包括化学纯乳糖、麦芽糖、葡萄糖及果糖；未加香料或着色剂的糖浆；人造蜜，不论是否掺有天然蜂蜜；焦糖,10,3902524693,5245307321,9147832014
17 ,第17章  糖及糖食,1703,制糖后所剩的糖蜜,2,0,552507,552507
17 ,第17章  糖及糖食,1704,不含可可的糖食（包括白巧克力）,2,1556930537,6708329776,8265260313
18 ,第18章  可可及可可制品,1801,整颗或破碎的可可豆，生的或焙炒的,1,84490836,266560,84757396
18 ,第18章  可可及可可制品,1802,可可荚、壳、皮及废料,1,8171009,0,8171009
18 ,第18章  可可及可可制品,1803,可可膏，不论是否脱脂,2,484771777,21516850,506288627
18 ,第18章  可可及可可制品,1804,可可脂、可可油,1,394254950,31830246,426085196
18 ,第18章  可可及可可制品,1805,未加糖或其他甜物质的可可粉,1,741840840,80368742,822209582
18 ,第18章  可可及可可制品,1806,巧克力及其他含可可的食品,5,2286514075,1868076940,4154591015
19 ,第19章  谷物、粮食粉、淀粉或乳的制品；糕饼点心,1901,麦精；细粉、粗粒、粗粉、淀粉或麦精制的其他品目未列名的食品，不含可可或按重量计全脱脂可可含量低于40%；品目0401至0404所列货品制的其他品目未列名的食品，不含可可或按重量计全脱脂可可含量低于5%,4,25225645566,1372033921,26597679487
19 ,第19章  谷物、粮食粉、淀粉或乳的制品；糕饼点心,1902,面食，不论是否煮熟、包馅（肉馅或其他馅）或其他方法制作，例如，通心粉、面条、汤团、馄饨、饺子、奶油面卷；古斯古斯面食，不论是否制作,8,1658530130,5886013548,7544543678
19 ,第19章  谷物、粮食粉、淀粉或乳的制品；糕饼点心,1903,珍粉及淀粉制成的珍粉代用品，片、粒、珠、粉或类似形状的,1,61114498,93639669,154754167
19 ,第19章  谷物、粮食粉、淀粉或乳的制品；糕饼点心,1904,谷物或谷物产品经膨化或烘炒制成的食品（例如，玉米片）；其他品目未列名的预煮或经其他方法制作的谷粒（玉米除外）、谷物片或经其他加工的谷粒（细粉、粗粒及粗粉除外）,4,1143437215,1491234630,2634671845
19 ,第19章  谷物、粮食粉、淀粉或乳的制品；糕饼点心,1905,面包、糕点、饼干及其他焙烘糕饼，不论是否含可可；圣餐饼、装药空囊、封缄、糯米纸及类似制品,6,5017545496,3060266429,8077811925
20 ,第20章  蔬菜、水果、坚果或植物其他部分的制品,2001,蔬菜、水果、坚果及植物的其他食用部分，用醋或醋酸制作或保藏的,3,96216708,803524111,899740819
20 ,第20章  蔬菜、水果、坚果或植物其他部分的制品,2002,番茄，用醋或醋酸以外的其他方法制作或保藏的,5,37500214,4046966595,4084466809
20 ,第20章  蔬菜、水果、坚果或植物其他部分的制品,2003,蘑菇及块菌，用醋或醋酸以外的其他方法制作或保藏的,5,23084893,9344548206,9367633099
20 ,第20章  蔬菜、水果、坚果或植物其他部分的制品,2004,其他冷冻蔬菜，用醋或醋酸以外的其他方法制作或保藏的，品目2006的货物除外,2,230909877,2399527787,2630437664
20 ,第20章  蔬菜、水果、坚果或植物其他部分的制品,2005,其他未冷冻蔬菜，用醋或醋酸以外的其他方法制作或保藏的，品目2006的货物除外,22,174967495,11697756691,11872724186
20 ,第20章  蔬菜、水果、坚果或植物其他部分的制品,2006,糖渍蔬菜、水果、坚果、果皮及植物的其他部分（沥干、糖渍或裹糖的）,3,606045099,1527499142,2133544241
20 ,第20章  蔬菜、水果、坚果或植物其他部分的制品,2007,烹煮的果酱、果冻、柑桔酱、果泥及果膏，不论是否加糖或其他甜物质,4,381406570,482483275,863889845
20 ,第20章  蔬菜、水果、坚果或植物其他部分的制品,2008,用其他方法制作或保藏的其他品目未列名水果、坚果及植物的其他食用部分，不论是否加酒、加糖或其他甜物质,33,3853214836,14155596640,18008811476
20 ,第20章  蔬菜、水果、坚果或植物其他部分的制品,2009,未发酵及未加酒精的水果汁或坚果汁（包括酿酒葡萄汁及椰子水）、蔬菜汁，不论是否加糖或其他甜物质,26,2758999885,4143979203,6902979088
21 ,第21章  杂项食品,2101,咖啡、茶、马黛茶的浓缩精汁及以其为基本成分或以咖啡、茶、马黛茶为基本成分的制品；烘焙菊苣和其他烘焙咖啡代用品及其浓缩汁,4,1962568282,1312879521,3275447803
21 ,第21章  杂项食品,2102,酵母（活性或非活性）；已死的其他单细胞微生物（不包括品目3002的疫苗）；发酵粉,3,95425723,1779388370,1874814093
21 ,第21章  杂项食品,2103,调味汁及其制品；混合调味品；芥子粉及其调制品,6,1028667993,10675284246,11703952239
21 ,第21章  杂项食品,2104,汤料及其制品；均化混合食品,2,67306036,451444909,518750945
21 ,第21章  杂项食品,2105,冰淇淋及其他冰制食品；不论是否含可可,1,422800972,251997728,674798700
21 ,第21章  杂项食品,2106,其他品目未列名的食品,9,22828967695,15944855175,38773822870
22 ,第22章  饮料、酒及醋,2201,未加糖或其他甜物质及未加味的水，包括天然或人造矿泉水及汽水；冰及雪,5,758816614,3536162528,4294979142
22 ,第22章  饮料、酒及醋,2202,加味、加糖或其他甜物质的水，包括矿泉水及汽水，其他无酒精饮料，但不包括品目20.09的水果汁、坚果汁或蔬菜汁,3,3915145389,1374114535,5289259924
22 ,第22章  饮料、酒及醋,2203,麦芽酿造的啤酒,1,3140530576,1622594393,4763124969
22 ,第22章  饮料、酒及醋,2204,鲜葡萄酿造的酒，包括加酒精的；品目2009以外的酿酒葡萄汁,5,7180323396,192561405,7372884801
22 ,第22章  饮料、酒及醋,2205,味美思酒及其他加植物或香料的用鲜葡萄酿造的酒,2,17551313,3045750,20597063
22 ,第22章  饮料、酒及醋,2206,其他发酵饮料（例如，苹果酒、梨酒、蜂蜜酒、清酒）；其他品目未列名的发酵饮料的混合物及发酵饮料与无酒精饮料的混合物,2,519703386,276262637,795966023
22 ,第22章  饮料、酒及醋,2207,未改性乙醇，按容量计酒精浓度≥80％；任何浓度的改性乙醇及其他酒精,2,16051327,52425744,68477071
22 ,第22章  饮料、酒及醋,2208,未改性乙醇，按容量计酒精浓度＜80％；蒸馏酒、利口酒及其他酒精饮料,9,9901612718,3929518440,13831131158
22 ,第22章  饮料、酒及醋,2209,醋及用醋酸制得的醋代用品,1,59880049,124947122,184827171
23 ,第23章  食品工业的残渣及废料；配制的动物饲料,2301,不适于供人食用的肉、杂碎、鱼、甲壳动物、软体动物或其他水生无脊椎动物的渣粉及团粒；油渣,6,16545014974,14693821,16559708795
23 ,第23章  食品工业的残渣及废料；配制的动物饲料,2302,谷物或豆类植物在筛、碾或其他加工过程中产生的糠、麸及其他残渣，不论是否制成团粒,4,2181567075,51410171,2232977246
23 ,第23章  食品工业的残渣及废料；配制的动物饲料,2303,制造淀粉过程中的残渣及类似的残渣、甜菜渣、甘蔗渣及制糖过程中的其他残渣，酿造及蒸馏过程中的糟粕积残渣，不论是否制成团粒糖,3,872507370,2441086710,3313594080
23 ,第23章  食品工业的残渣及废料；配制的动物饲料,2304,提炼豆油所得的油渣饼及其他固体残渣，不论是否碾磨或制成团粒,2,216093271,1659919549,1876012820
23 ,第23章  食品工业的残渣及废料；配制的动物饲料,2305,提炼花生油所得的油渣饼及其他固体残渣，不论是否碾磨或制成团粒,1,364689055,5499389,370188444
23 ,第23章  食品工业的残渣及废料；配制的动物饲料,2306,品目23.04或23.05以外的提炼植物或微生物油脂所得的油渣饼及其他固体残渣，不论是否碾磨或制成团粒,8,10469559844,186567221,10656127065
23 ,第23章  食品工业的残渣及废料；配制的动物饲料,2307,葡萄酒渣；粗酒石,1,0,0,0
23 ,第23章  食品工业的残渣及废料；配制的动物饲料,2308,动物饲料用的其他处未列名的植物原料、废料、残渣及副产品，不论是否制成团粒,1,117825140,545738937,663564077
23 ,第23章  食品工业的残渣及废料；配制的动物饲料,2309,配制的动物饲料,4,5615332269,15004244542,20619576811
24 ,第24章  烟草、烟草及烟草代用品的制品；非经燃烧吸用的产品，不论是否含有尼古丁；其他供人体摄入尼古丁的含尼古丁的产品,2401,烟草；烟草废料,5,6882236769,2937186283,9819423052
24 ,第24章  烟草、烟草及烟草代用品的制品；非经燃烧吸用的产品，不论是否含有尼古丁；其他供人体摄入尼古丁的含尼古丁的产品,2402,烟草或烟草代用品制成的雪茄烟及卷烟,3,1347498406,564920779,1912419185
24 ,第24章  烟草、烟草及烟草代用品的制品；非经燃烧吸用的产品，不论是否含有尼古丁；其他供人体摄入尼古丁的含尼古丁的产品,2403,其他烟草及烟草代用品的制品；“均化”或“再造”烟草；烟草精汁,4,191350887,212005501,403356388
24 ,第24章  烟草、烟草及烟草代用品的制品；非经燃烧吸用的产品，不论是否含有尼古丁；其他供人体摄入尼古丁的含尼古丁的产品,2404,含烟草、再造烟草、尼古丁、或烟草或尼古丁代用品，非经燃烧吸用的产品；其他供人体摄入尼古丁的含尼古丁的产品,7,231480776,31257370761,31488851537
25 ,第25章  盐；硫磺；泥土及石料；石膏料、石灰及水泥,2501,盐（包括精制盐及变性盐）及纯氯化钠，不论是否为水溶液，也不论是否添加抗结块剂或松散剂；海水,4,2622068254,614153281,3236221535
25 ,第25章  盐；硫磺；泥土及石料；石膏料、石灰及水泥,2502,未焙烧的黄铁矿,1,356392134,26340108,382732242
25 ,第25章  盐；硫磺；泥土及石料；石膏料、石灰及水泥,2503,各种硫磺，但升华硫磺、沉淀硫磺及胶态硫磺除外,1,13537933756,6525046,13544458802
25 ,第25章  盐；硫磺；泥土及石料；石膏料、石灰及水泥,2504,天然石墨,4,596964742,1896358019,2493322761
25 ,第25章  盐；硫磺；泥土及石料；石膏料、石灰及水泥,2505,各种天然砂，不论是否着色，但第26章的含金属矿砂除外,2,1092741236,76249936,1168991172
25 ,第25章  盐；硫磺；泥土及石料；石膏料、石灰及水泥,2506,石英（天然砂除外）；石英岩，不论是否粗加修整或仅用锯或其他方法切割成矩形（包括正方形）的板、块,2,1410815958,1077842903,2488658861
25 ,第25章  盐；硫磺；泥土及石料；石膏料、石灰及水泥,2507,高岭土及类似土，不论是否锻烧,2,740550347,1217804646,1958354993
25 ,第25章  盐；硫磺；泥土及石料；石膏料、石灰及水泥,2508,其他黏土（不包括品目6806的膨胀黏土）、红柱石、蓝晶石及硅线石，不论是否煅烧；富铝红柱石；火泥及第纳斯土,6,448551632,2134895164,2583446796
25 ,第25章  盐；硫磺；泥土及石料；石膏料、石灰及水泥,2509,白垩,1,7345474,453297,7798771
25 ,第25章  盐；硫磺；泥土及石料；石膏料、石灰及水泥,2510,天然磷酸钙、天然磷酸铝钙及磷酸盐白垩,4,36934386,584246871,621181257
25 ,第25章  盐；硫磺；泥土及石料；石膏料、石灰及水泥,2511,天然硫酸钡（重晶石）；天然碳酸钡（毒重石），不论是否煅烧，但品目2816的氧化钡除外,2,44714175,661012391,705726566
25 ,第25章  盐；硫磺；泥土及石料；石膏料、石灰及水泥,2512,硅质化石粗粉（例如各种硅藻土）及类似的硅质土，不论是否煅烧，其表观比重不超过1,2,63286267,76546944,139833211
25 ,第25章  盐；硫磺；泥土及石料；石膏料、石灰及水泥,2513,浮石；刚玉岩；天然刚玉砂；天然石榴石及其他天然磨料，不论是否热处理,2,106379046,332320597,438699643
25 ,第25章  盐；硫磺；泥土及石料；石膏料、石灰及水泥,2514,板岩，不论是否粗加修整或仅用锯或其他方法切割成矩形（包括正方形）的板、块,1,2716618,187042362,189758980
25 ,第25章  盐；硫磺；泥土及石料；石膏料、石灰及水泥,2515,大理石、石灰华及其他石灰质碑用或建筑用石，表观比重≥2.5，蜡石，不论是否粗加修整或仅用锯或其他方法切割成矩形（包括正方形）的板、块,3,6546041054,213989300,6760030354
25 ,第25章  盐；硫磺；泥土及石料；石膏料、石灰及水泥,2516,花岗岩、斑岩、玄武岩、砂岩以及其他等碑用或建筑用石，不论是否粗加修整或仅用锯或其他方法切割成矩形（包括正方形）的板、块,4,5296717314,131495235,5428212549
25 ,第25章  盐；硫磺；泥土及石料；石膏料、石灰及水泥,2517,通常作混凝土粒料、铺路、铁道路基或其他路基的卵石、砾石及碎石，圆石子及燧石，不论是否热处理；矿渣、浮渣及类似的工业残渣，不论是否混有本品目第一部分所列的材料；沥青碎石，品名2515、2516所列各种石料的碎粒、碎屑及粉末，不论是否认处理,5,61195213,1373510295,1434705508
25 ,第25章  盐；硫磺；泥土及石料；石膏料、石灰及水泥,2518,白云石，不论是否煅烧或烧结、粗加修整或仅用锯或其他方法切割成矩形（包括正方形）的板、块,2,423166671,191005231,614171902
25 ,第25章  盐；硫磺；泥土及石料；石膏料、石灰及水泥,2519,天然碳酸镁（菱镁矿）；熔凝镁氧矿；烧结镁氧矿，不论烧结前是否加入少量的其他氧化物；其他氧化镁不论是否纯净,6,275188322,5554746262,5829934584
25 ,第25章  盐；硫磺；泥土及石料；石膏料、石灰及水泥,2520,生石膏；硬石膏；熟石膏（由煅烧的生石膏或硫酸钙构成），不论是否着色，也不论是否带有少量促凝剂或缓凝剂,3,309361213,142086561,451447774
25 ,第25章  盐；硫磺；泥土及石料；石膏料、石灰及水泥,2521,石灰石助熔剂；通常用于制造石灰或水泥的石灰石及其他钙质石,1,1825628,10621150,12446778
25 ,第25章  盐；硫磺；泥土及石料；石膏料、石灰及水泥,2522,生石灰、熟石灰及水硬石灰，但品目2825的氧化钙及氢氧化钙除外,3,27461327,96652733,124114060
25 ,第25章  盐；硫磺；泥土及石料；石膏料、石灰及水泥,2523,硅酸盐水泥、矾土水泥、矿渣水泥、富硫酸盐水泥及类似的水凝水泥,5,3514742565,904717123,4419459688
25 ,第25章  盐；硫磺；泥土及石料；石膏料、石灰及水泥,2524,石棉,3,266303886,47379725,313683611
25 ,第25章  盐；硫磺；泥土及石料；石膏料、石灰及水泥,2525,云母，包括云母片；云母废料,3,338583324,222391549,560974873
25 ,第25章  盐；硫磺；泥土及石料；石膏料、石灰及水泥,2526,天然冻石，不论是否粗加修整或仅用锯或其他方法切割成矩形（包括正方形）的板、块；滑石,4,211012139,747807751,958819890
25 ,第25章  盐；硫磺；泥土及石料；石膏料、石灰及水泥,2528,天然硼酸盐及其精矿(不论是否煅烧)，但不包括从天然盐水析离的硼酸盐；天然粗硼酸，含硼酸干重不超过85％,2,926784199,7418497,934202696
25 ,第25章  盐；硫磺；泥土及石料；石膏料、石灰及水泥,2529,长石；白榴石；霞石及霞石正长岩；萤石（氟石）,4,396561119,1164443649,1561004768
25 ,第25章  盐；硫磺；泥土及石料；石膏料、石灰及水泥,2530,其他品目未列名的矿产品,7,37119254947,1100619778,38219874725
26 ,第26章  矿砂、矿渣及矿灰,2601,铁矿砂及其精矿，包括焙烧黄铁矿,5,6.68687E+11,17170070885,6.85857E+11
26 ,第26章  矿砂、矿渣及矿灰,2602,锰矿砂及其精矿，包括以干重计锰含量≥20%的含铁锰矿砂及其精矿,1,28916377692,35265636,28951643328
26 ,第26章  矿砂、矿渣及矿灰,2603,铜矿砂及其精矿,1,2.94361E+11,247075,2.94361E+11
26 ,第26章  矿砂、矿渣及矿灰,2604,镍矿砂及其精矿,1,22522852603,15037,22522867640
26 ,第26章  矿砂、矿渣及矿灰,2605,钴矿砂及其精矿,1,833776825,0,833776825
26 ,第26章  矿砂、矿渣及矿灰,2606,铝矿砂及其精矿,1,35815787876,55807778,35871595654
26 ,第26章  矿砂、矿渣及矿灰,2607,铅矿砂及其精矿,1,7230043660,969,7230044629
26 ,第26章  矿砂、矿渣及矿灰,2608,锌矿砂及其精矿,1,23259388872,735,23259389607
26 ,第26章  矿砂、矿渣及矿灰,2609,锡矿砂及其精矿,1,11389102780,6200538,11395303318
26 ,第26章  矿砂、矿渣及矿灰,2610,铬矿砂及其精矿,1,18194728938,33280727,18228009665
26 ,第26章  矿砂、矿渣及矿灰,2611,钨矿砂及其精矿,1,307402858,1461335,308864193
26 ,第26章  矿砂、矿渣及矿灰,2612,铀或钍矿砂及其精矿,2,1152101021,0,1152101021
26 ,第26章  矿砂、矿渣及矿灰,2613,钼矿砂及其精矿,2,2502267310,1383228427,3885495737
26 ,第26章  矿砂、矿渣及矿灰,2614,钛矿砂及其精矿,1,6970478602,208056088,7178534690
26 ,第26章  矿砂、矿渣及矿灰,2615,铌、钽、钒或锆矿砂及其精矿,3,8508288685,250820537,8759109222
26 ,第26章  矿砂、矿渣及矿灰,2616,贵金属矿砂及其精矿,2,32571355258,73880722,32645235980
26 ,第26章  矿砂、矿渣及矿灰,2617,其他矿砂及其精矿,4,766867602,32991296,799858898
26 ,第26章  矿砂、矿渣及矿灰,2618,冶炼钢铁所产生的粒状熔渣（熔渣砂）,2,0,5878211,5878211
26 ,第26章  矿砂、矿渣及矿灰,2619,冶炼钢铁所产生的熔渣、浮渣（粒状熔渣除外）、氧化皮及其他废料,1,0,187292841,187292841
26 ,第26章  矿砂、矿渣及矿灰,2620,含有金属、砷及其化合物的矿渣、矿灰及残渣（冶炼钢铁所产生的灰、渣除外）,10,0,123643763,123643763
26 ,第26章  矿砂、矿渣及矿灰,2621,其他矿渣及矿灰，包括海藻灰（海草灰）；焚化城市垃圾所产生的灰、渣,2,4776524,814109339,818885863
27 ,第27章  矿物燃料、矿物油及其蒸馏产品；沥青物质；矿物蜡,2701,煤；煤砖、煤球及用煤制成的类似固体燃料,5,1.415E+11,6416936772,1.47917E+11
27 ,第27章  矿物燃料、矿物油及其蒸馏产品；沥青物质；矿物蜡,2702,褐煤，不论是否制成型，但不包括黑玉,2,57339951490,2848866,57342800356
27 ,第27章  矿物燃料、矿物油及其蒸馏产品；沥青物质；矿物蜡,2703,泥煤（包括肥料用泥煤），不论是否制成型,1,581612621,2783857,584396478
27 ,第27章  矿物燃料、矿物油及其蒸馏产品；沥青物质；矿物蜡,2704,煤、褐煤或泥煤制成的焦炭及半焦炭，不论是否制成型；甑炭,2,1044172082,22533435606,23577607688
27 ,第27章  矿物燃料、矿物油及其蒸馏产品；沥青物质；矿物蜡,2705,煤气、水煤气、炉煤气及类似气体，但石油气及其他烃类气除外,1,0,99953,99953
27 ,第27章  矿物燃料、矿物油及其蒸馏产品；沥青物质；矿物蜡,2706,从煤、褐煤或泥煤蒸馏所得的焦油及其他矿物焦油，不论是否脱水或部分蒸馏,1,292836566,46985118,339821684
27 ,第27章  矿物燃料、矿物油及其蒸馏产品；沥青物质；矿物蜡,2707,蒸馏高温煤焦油所得的油类及其他产品；芳族成分重量超过非芳族成分的类品,8,9521853196,880435838,10402289034
27 ,第27章  矿物燃料、矿物油及其蒸馏产品；沥青物质；矿物蜡,2708,从煤焦油或其他矿物焦油所得的沥青及沥青焦,2,516206132,4165849173,4682055305
27 ,第27章  矿物燃料、矿物油及其蒸馏产品；沥青物质；矿物蜡,2709,石油原油及从沥青矿物提取的原油,1,1.78104E+12,8534102480,1.78957E+12
27 ,第27章  矿物燃料、矿物油及其蒸馏产品；沥青物质；矿物蜡,2710,石油及从沥青矿物提取的油类，但原油除外；以上述油为基本成分(按重量计不低于70%)的其他品目未列名制品；废油,19,91217629796,2.11903E+11,3.03121E+11
27 ,第27章  矿物燃料、矿物油及其蒸馏产品；沥青物质；矿物蜡,2711,石油气及其他烃类气,9,4.29902E+11,17634895326,4.47537E+11
27 ,第27章  矿物燃料、矿物油及其蒸馏产品；沥青物质；矿物蜡,2712,凡士林；石蜡、微晶石蜡、疏松石蜡、地蜡、褐煤蜡、泥煤蜡、其他矿物蜡及用合成或其他方法制得的类似产品，不论是否着色,4,596386451,5710872516,6307258967
27 ,第27章  矿物燃料、矿物油及其蒸馏产品；沥青物质；矿物蜡,2713,石油焦、石油沥青及其他石油或从沥青矿物提取的油类残渣,6,30089334512,9019027079,39108361591
27 ,第27章  矿物燃料、矿物油及其蒸馏产品；沥青物质；矿物蜡,2714,天然沥青（地沥青）、沥青页岩、油页岩及焦油砂；沥青岩,4,285846730,6212458,292059188
27 ,第27章  矿物燃料、矿物油及其蒸馏产品；沥青物质；矿物蜡,2715,以天然沥青（地沥青）、石油沥青、矿物焦油或矿物焦油沥青为基本成分的沥青混合物（例如，沥青胶粘剂、稀释沥青）,1,39749945264,42032111,39791977375
27 ,第27章  矿物燃料、矿物油及其蒸馏产品；沥青物质；矿物蜡,2716,电力,1,1475201539,7835823906,9311025445
28 ,第28章  无机化学品；贵金属、稀土金属、放射性元素及其同位素的有机及无机化合物,2801,氟、氯、溴及碘,4,3664592624,3121531,3667714155
28 ,第28章  无机化学品；贵金属、稀土金属、放射性元素及其同位素的有机及无机化合物,2802,升华硫磺、沉淀硫磺；胶态硫磺,1,4357742,600981,4958723
28 ,第28章  无机化学品；贵金属、稀土金属、放射性元素及其同位素的有机及无机化合物,2803,碳（碳黑及其他品目未列名的其他形态的碳）,1,1673979178,6982330259,8656309437
28 ,第28章  无机化学品；贵金属、稀土金属、放射性元素及其同位素的有机及无机化合物,2804,氢、稀有气体及其他非金属,16,16102959931,15367070320,31470030251
28 ,第28章  无机化学品；贵金属、稀土金属、放射性元素及其同位素的有机及无机化合物,2805,碱金属、碱土金属；稀土金属、钪及钇，不论是否相互混合或相互熔合；汞,16,24032970,3610145241,3634178211
28 ,第28章  无机化学品；贵金属、稀土金属、放射性元素及其同位素的有机及无机化合物,2806,氯化氢（盐酸）；氯磺酸,2,108017282,62113327,170130609
28 ,第28章  无机化学品；贵金属、稀土金属、放射性元素及其同位素的有机及无机化合物,2807,硫酸；发烟硫酸,1,234987737,2598463358,2833451095
28 ,第28章  无机化学品；贵金属、稀土金属、放射性元素及其同位素的有机及无机化合物,2808,硝酸；磺硝酸,1,136060554,52043690,188104244
28 ,第28章  无机化学品；贵金属、稀土金属、放射性元素及其同位素的有机及无机化合物,2809,五氧化二磷；磷酸；多磷酸，不论是否已有化学定义,4,292033287,5078616494,5370649781
28 ,第28章  无机化学品；贵金属、稀土金属、放射性元素及其同位素的有机及无机化合物,2810,硼的氧化物；硼酸,2,1273231364,57434988,1330666352
28 ,第28章  无机化学品；贵金属、稀土金属、放射性元素及其同位素的有机及无机化合物,2811,其他无机酸及非金属无机氧化物,9,3143763650,8661610082,11805373732
28 ,第28章  无机化学品；贵金属、稀土金属、放射性元素及其同位素的有机及无机化合物,2812,非金属卤化物及卤氧化物,12,514819095,1103678797,1618497892
28 ,第28章  无机化学品；贵金属、稀土金属、放射性元素及其同位素的有机及无机化合物,2813,非金属硫化物；商品三硫化二磷,2,3720979,257663808,261384787
28 ,第28章  无机化学品；贵金属、稀土金属、放射性元素及其同位素的有机及无机化合物,2814,氨及氨水,2,1361593664,540699753,1902293417
28 ,第28章  无机化学品；贵金属、稀土金属、放射性元素及其同位素的有机及无机化合物,2815,氢氧化钠（烧碱）；氢氧化钾（苛性钾）；过氧化钠及过氧化钾,4,95195428,8317635059,8412830487
28 ,第28章  无机化学品；贵金属、稀土金属、放射性元素及其同位素的有机及无机化合物,2816,氢氧化及过氧化镁；锶或钡的氧化物、氢氧化物及过氧化物,2,103744214,239112154,342856368
28 ,第28章  无机化学品；贵金属、稀土金属、放射性元素及其同位素的有机及无机化合物,2817,氧化锌及过氧化锌,2,105532424,315030001,420562425
28 ,第28章  无机化学品；贵金属、稀土金属、放射性元素及其同位素的有机及无机化合物,2818,人造刚玉，不论是否已有化学定义；氧化铝；氢氧化铝,4,5325058726,10497111211,15822169937
28 ,第28章  无机化学品；贵金属、稀土金属、放射性元素及其同位素的有机及无机化合物,2819,铬的氧化物及氢氧化物,2,49650573,349131925,398782498
28 ,第28章  无机化学品；贵金属、稀土金属、放射性元素及其同位素的有机及无机化合物,2820,锰的氧化物,2,70606226,775394099,846000325
28 ,第28章  无机化学品；贵金属、稀土金属、放射性元素及其同位素的有机及无机化合物,2821,铁的氧化物及氢氧化物；土色料，按重量计三氧化二铁含量≥70%,2,490193913,2470023192,2960217105
28 ,第28章  无机化学品；贵金属、稀土金属、放射性元素及其同位素的有机及无机化合物,2822,钴的氧化物及氢氧化物；商品氧化钴,2,37667613,1534510597,1572178210
28 ,第28章  无机化学品；贵金属、稀土金属、放射性元素及其同位素的有机及无机化合物,2823,钛的氧化物,1,205730666,845444810,1051175476
28 ,第28章  无机化学品；贵金属、稀土金属、放射性元素及其同位素的有机及无机化合物,2824,铅的氧化物；铅丹及铅橙,3,2870198,13322144,16192342
28 ,第28章  无机化学品；贵金属、稀土金属、放射性元素及其同位素的有机及无机化合物,2825,肼（联氨）、胲（羟胺）及其无机盐；其他无机碱；其他金属氧化物、氢氧化物及过氧化物,22,2001460115,30597441359,32598901474
28 ,第28章  无机化学品；贵金属、稀土金属、放射性元素及其同位素的有机及无机化合物,2826,氟化物；氟硅酸盐、氟铝酸盐及其他氟络盐,10,1020769455,3931942514,4952711969
28 ,第28章  无机化学品；贵金属、稀土金属、放射性元素及其同位素的有机及无机化合物,2827,氯化物、氯氧化物及氢氧基氯化物；溴化物及溴氧化物；碘化物及碘氧化物,16,1468966503,4235760008,5704726511
28 ,第28章  无机化学品；贵金属、稀土金属、放射性元素及其同位素的有机及无机化合物,2828,次氯酸盐；商品次氯酸钙；亚氯酸盐；次溴酸盐,2,108815633,969616366,1078431999
28 ,第28章  无机化学品；贵金属、稀土金属、放射性元素及其同位素的有机及无机化合物,2829,氯酸盐及高氯酸盐；溴酸盐及过溴酸盐；碘酸盐及高碘酸盐,4,38449095,352807390,391256485
28 ,第28章  无机化学品；贵金属、稀土金属、放射性元素及其同位素的有机及无机化合物,2830,硫化物；多硫化物，不论是否已有化学定义,5,150300072,1036686342,1186986414
28 ,第28章  无机化学品；贵金属、稀土金属、放射性元素及其同位素的有机及无机化合物,2831,连二亚硫酸盐及次硫酸盐,3,40714945,826317023,867031968
28 ,第28章  无机化学品；贵金属、稀土金属、放射性元素及其同位素的有机及无机化合物,2832,亚硫酸盐；硫代硫酸盐,3,17234267,1279091347,1296325614
28 ,第28章  无机化学品；贵金属、稀土金属、放射性元素及其同位素的有机及无机化合物,2833,硫酸盐；矾；过硫酸盐,14,3593497572,7120565771,10714063343
28 ,第28章  无机化学品；贵金属、稀土金属、放射性元素及其同位素的有机及无机化合物,2834,亚硝酸盐；硝酸盐,5,83398338,1234570316,1317968654
28 ,第28章  无机化学品；贵金属、稀土金属、放射性元素及其同位素的有机及无机化合物,2835,次磷酸盐、亚磷酸盐及磷酸盐；多磷酸盐，不论是否已有化学定义,14,475546968,10299672833,10775219801
28 ,第28章  无机化学品；贵金属、稀土金属、放射性元素及其同位素的有机及无机化合物,2836,碳酸盐；过碳酸盐；含氨基甲酸铵的商品碳酸铵,12,34443516743,10585935286,45029452029
28 ,第28章  无机化学品；贵金属、稀土金属、放射性元素及其同位素的有机及无机化合物,2837,氰化物、氧氰化物及氰络合物,5,99259812,1658491655,1757751467
28 ,第28章  无机化学品；贵金属、稀土金属、放射性元素及其同位素的有机及无机化合物,2839,硅酸盐；商品碱金属硅酸盐,4,127960126,1095150741,1223110867
28 ,第28章  无机化学品；贵金属、稀土金属、放射性元素及其同位素的有机及无机化合物,2840,硼酸盐及过硼酸盐,4,2149922572,191152240,2341074812
28 ,第28章  无机化学品；贵金属、稀土金属、放射性元素及其同位素的有机及无机化合物,2841,金属酸盐及过金属酸盐,13,2509061496,2330166488,4839227984
28 ,第28章  无机化学品；贵金属、稀土金属、放射性元素及其同位素的有机及无机化合物,2842,其他无机酸盐及过氧酸盐（包括不论是否已有化学定义的硅铝酸盐），但叠氮化物除外,9,24117672529,23269538291,47387210820
28 ,第28章  无机化学品；贵金属、稀土金属、放射性元素及其同位素的有机及无机化合物,2843,胶态贵金属；贵金属的无机或有机化合物，不论是否已有化学定义；贵金属汞齐,5,2547535297,355724296,2903259593
28 ,第28章  无机化学品；贵金属、稀土金属、放射性元素及其同位素的有机及无机化合物,2844,放射性化学元素及放射性同位素（包括可裂变或可转换的化学元素及同位素）及其化合物；含上述产品的混合物及残渣,11,9327874939,470696153,9798571092
28 ,第28章  无机化学品；贵金属、稀土金属、放射性元素及其同位素的有机及无机化合物,2845,品目28.44以外的同位素；这些同位素的无机或有机化合物，不论是否已有化学定义,5,1037039758,532081794,1569121552
28 ,第28章  无机化学品；贵金属、稀土金属、放射性元素及其同位素的有机及无机化合物,2846,稀土金属、钇、钪及其混合物的无机或有机化合物,43,4328474300,3342970009,7671444309
28 ,第28章  无机化学品；贵金属、稀土金属、放射性元素及其同位素的有机及无机化合物,2847,过氧化氢，不论是否用尿素固化,1,158646152,117020102,275666254
28 ,第28章  无机化学品；贵金属、稀土金属、放射性元素及其同位素的有机及无机化合物,2849,碳化物，不论是否已有化学定义,5,123832433,4820982471,4944814904
28 ,第28章  无机化学品；贵金属、稀土金属、放射性元素及其同位素的有机及无机化合物,2850,氢化物、氮化物、叠氮化物、硅化物及硼化物，不论是否已有化学定义，但可归入品目2849的碳化物除外,4,593512411,749167132,1342679543
28 ,第28章  无机化学品；贵金属、稀土金属、放射性元素及其同位素的有机及无机化合物,2852,汞的无机或有机化合物，不论是否已有化学定义，汞齐除外,2,188616,0,188616
28 ,第28章  无机化学品；贵金属、稀土金属、放射性元素及其同位素的有机及无机化合物,2853,磷化物，不论是否已有化学定义，但磷铁除外；其他无机化合物（包括蒸馏水、导电水及类似的纯净水）；液态空气（不论是否除去稀有气体）；压缩空气；汞齐，但贵金属汞齐除外,6,1246370666,13491914276,14738284942
29 ,第29章  有机化学品,2901,无环烃,11,34359355837,3293585937,37652941774
29 ,第29章  有机化学品,2902,环烃,19,87741177025,12042297258,99783474283
29 ,第29章  有机化学品,2903,烃的卤化衍生物,52,7211229440,16073020003,23284249443
29 ,第29章  有机化学品,2904,烃的磺化、硝化或亚硝化衍生物，不论是否卤化,14,332585302,1940114805,2272700107
29 ,第29章  有机化学品,2905,无环醇及其卤化、磺化、硝化或亚硝化衍生物,30,58885058520,12660263554,71545322074
29 ,第29章  有机化学品,2906,环醇及其卤化、磺化、硝化或亚硝化衍生物,9,1507062154,3927517560,5434579714
29 ,第29章  有机化学品,2907,酚；酚醇,18,8133368967,2717446308,10850815275
29 ,第29章  有机化学品,2908,酚及酚醇的卤化、磺化、硝化或亚硝化衍生物,7,2604982670,496356510,3101339180
29 ,第29章  有机化学品,2909,醚、醚醇、醚酚、醚醇酚、过氧化醇、过氧化醚、缩醛及半缩醛过氧化物、过氧化酮(不论是否已有化学定义）及其卤化、磺化、硝化或亚硝化衍生物,15,6002014930,15922514182,21924529112
29 ,第29章  有机化学品,2910,三节环环氧化物、环氧醇、环氧酚、环氧醚及其卤化、磺化、硝化或亚硝化衍生物,6,2861602150,2194150184,5055752334
29 ,第29章  有机化学品,2911,缩醛及半缩醛，不论是否含有其他含氧基，及其卤化、磺化、硝化或亚硝化衍生物,1,30030036,71555665,101585701
29 ,第29章  有机化学品,2912,醛，不论是否含有其他含氧基；环聚醛；多聚甲醛,12,926598453,4016245232,4942843685
29 ,第29章  有机化学品,2913,品目2912产品的卤化、磺化、硝化或亚硝化衍生物,1,36436003,262245506,298681509
29 ,第29章  有机化学品,2914,酮及醌，不论是否含有其他含氧基，及其卤化、磺化、硝化或亚硝化衍生物,21,3659482050,10358757003,14018239053
29 ,第29章  有机化学品,2915,饱和无环一元羧酸及其酸酐、酰卤化物、过氧化物和过氧酸以及它们的卤化、磺化、硝化或亚硝化衍生物,21,7129045552,17474468058,24603513610
29 ,第29章  有机化学品,2916,不饱和无环一元羧酸、环一元羧酸及其酸酐、酰卤化物、过氧化物和过氧酸以及它们的卤化、磺化、硝化或亚硝化衍生物,20,2784721452,16942860037,19727581489
29 ,第29章  有机化学品,2917,多元羧酸及其酸酐、酰卤化物、过氧化物和过氧酸以及它们的卤化、磺化、硝化或亚硝化衍生物,21,3299749336,28839373436,32139122772
29 ,第29章  有机化学品,2918,含附加含氧基的羧酸及其酸酐、酰卤化物、过氧化物和过氧酸以及它们的卤化、磺化、硝化或亚硝化衍生物,18,1564666478,27145282288,28709948766
29 ,第29章  有机化学品,2919,磷酸脂及其盐，包括乳磷酸盐，以及它们的卤化、磺化、硝化或亚硝化衍生物,2,197794178,3648003302,3845797480
29 ,第29章  有机化学品,2920,其他非金属无机酸酯（不包括卤化氢的酯）及其盐以及它们的卤化、磺化、硝化或亚硝化衍生物,10,998703032,3511570574,4510273606
29 ,第29章  有机化学品,2921,氨基化合物,32,4095438313,17371660248,21467098561
29 ,第29章  有机化学品,2922,含氧基氨基化合物,37,2588934878,33432247308,36021182186
29 ,第29章  有机化学品,2923,季铵盐及季铵碱；卵磷脂及其他磷氨基类脂,5,613017073,3835047285,4448064358
29 ,第29章  有机化学品,2924,羧基酰胺基化合物；碳酸酰胺基化合物,12,3247362932,18172889239,21420252171
29 ,第29章  有机化学品,2925,羧基酰亚胺化合物（包括糖精及其盐）及亚胺基化合物,5,1501058751,4127344810,5628403561
29 ,第29章  有机化学品,2926,腈基化合物,7,6262473400,9033323535,15295796935
29 ,第29章  有机化学品,2927,重氮化合物、偶氮化合物及氧化偶氮化合物,1,158568084,1406959077,1565527161
29 ,第29章  有机化学品,2928,肼（联氨）及胲（羟胺）的有机衍生物,1,701668059,1732274911,2433942970
29 ,第29章  有机化学品,2929,其他含氮基化合物,10,1986093185,8929933818,10916027003
29 ,第29章  有机化学品,2930,有机硫化合物,10,4255258115,18286848129,22542106244
29 ,第29章  有机化学品,2931,其他有机?无机化合物,18,2431998671,36293675642,38725674313
29 ,第29章  有机化学品,2932,仅含氧杂原子的杂环化合物,17,1993943862,19936006182,21929950044
29 ,第29章  有机化学品,2933,仅含有氮杂原子的杂环化合物,36,15553768727,91144959281,1.06699E+11
29 ,第29章  有机化学品,2934,核酸及其盐，不论是否已有化学定义；其他杂环化合物,13,3130717528,24636646361,27767363889
29 ,第29章  有机化学品,2935,磺（酰）胺,6,2051632398,4585876334,6637508732
29 ,第29章  有机化学品,2936,天然或合成再制的维生素原和维生素（包括天然浓缩物）及其主要用作维生素的衍生物，上述产品的混合物，不论是否溶于溶剂,11,1071481203,17290467706,18361948909
29 ,第29章  有机化学品,2937,天然或合成再制的激素、前列腺素、血栓烷、白细胞三烯及其衍生物和结构类似物，包括主要用作激素的改性链多肽,13,9223845429,5746205945,14970051374
29 ,第29章  有机化学品,2938,天然或合成再制的苷（配糖物）及其盐、醚、酯和其他衍生物,3,418774660,4664371991,5083146651
29 ,第29章  有机化学品,2939,天然或合成再制的生物碱及其盐、醚、酯和其他衍生物,22,297748863,2024950446,2322699309
29 ,第29章  有机化学品,2940,化学纯糖，但蔗糖、乳糖、麦芽糖、葡萄糖及果糖除外；糖醚、糖缩醛、糖酯及其盐，但不包括品目2937、2938及2939的产品,2,112683489,1154828768,1267512257
29 ,第29章  有机化学品,2941,抗菌素,31,2199907375,21631891001,23831798376
29 ,第29章  有机化学品,2942,其他有机化合物,1,233310468,238136351,471446819
30 ,第30章  药品,3001,已干燥的器官疗法用腺体及其他器官，不论是否制成粉末；器官疗法用腺体、其他器官及其分泌物的提取物；肝素及其盐；其他供治疗或预防疾病用的其他品目未列名的人体或动物制品,3,1398921820,9423003798,10821925618
30 ,第30章  药品,3002,人血；治病、防病或诊断用的动物血制品；抗血清、其他血份及免疫制品，不论是否修饰或通过生物工艺加工制得；疫苗、毒素、培养微生物(不包括酵母）及类似产品；细胞培养物，不论是否修饰,14,78962995616,11506622699,90469618315
30 ,第30章  药品,3003,两种或两种以上成分混合而成的治病或防病药品（不包括品目3002、3005或3006的货品），未配定剂量或制成零售包装,24,2066488419,5591377717,7657866136
30 ,第30章  药品,3004,由混合或非混合产品构成的治病或防病用药品（不包括品目3002、3005或3006的货品），已配定剂量（包括制成皮肤摄入形式的）或制成零售包装,35,1.11034E+11,29146371437,1.40181E+11
30 ,第30章  药品,3005,软填料、纱布、绷带及类似物品（例如，敷料、橡皮膏、泥罨剂），经过药物浸涂或制成零售包装供医疗、外科、牙科或兽医用,4,1582588000,11518810025,13101398025
30 ,第30章  药品,3006,本章注释4 所规定的医药用品,10,6043579834,4571825841,10615405675
31 ,第31章  肥料,3101,动物或植物肥料，不论是否相互混合或经化学处理；动物产品经混合或化学处理制成的肥料,3,37954594,241042782,278997376
31 ,第31章  肥料,3102,矿物氮肥及化学氮肥,10,117466118,22286159729,22403625847
31 ,第31章  肥料,3103,矿物磷肥及化学磷肥,4,2018461,2557837454,2559855915
31 ,第31章  肥料,3104,矿物钾肥及化学钾肥,5,21388221032,536635360,21924856392
31 ,第31章  肥料,3105,含氮、磷、钾中二种或三种肥效元素的矿物肥料或化学肥料；其他肥料；制成片或类似形状或每包毛重不超过10千克的本章各项货品,9,3443950862,27968461151,31412412013
32 ,第32章  鞣料浸膏及染料浸膏；鞣酸及其衍生物；染料、颜料及其他着色料；油漆及清漆；油灰及其他类似胶粘剂；墨水、油墨,3201,植物鞣料浸膏；鞣酸及其盐、醚、酯和其他衍生物,4,180272419,9993031,190265450
32 ,第32章  鞣料浸膏及染料浸膏；鞣酸及其衍生物；染料、颜料及其他着色料；油漆及清漆；油灰及其他类似胶粘剂；墨水、油墨,3202,有机合成鞣料；无机鞣料；鞣料制剂，不论是否含有天然鞣料；预鞣用酶制剂,2,590401219,158928924,749330143
32 ,第32章  鞣料浸膏及染料浸膏；鞣酸及其衍生物；染料、颜料及其他着色料；油漆及清漆；油灰及其他类似胶粘剂；墨水、油墨,3203,动植物质着色料（包括染料浸膏，但动物炭黑除外），不论是否已有化学定义；本章注释3所述的以动植物质着色料为基本成分的制品,3,162106767,1491305455,1653412222
32 ,第32章  鞣料浸膏及染料浸膏；鞣酸及其衍生物；染料、颜料及其他着色料；油漆及清漆；油灰及其他类似胶粘剂；墨水、油墨,3204,有机合成着色料，不论是否已有化学定义；本章注释3所述的以有机合成着色料为基本成分的制品；用作荧光增白剂或发光体的有机合成产品，不论是否已有化学定义,16,6090165986,15013176014,21103342000
32 ,第32章  鞣料浸膏及染料浸膏；鞣酸及其衍生物；染料、颜料及其他着色料；油漆及清漆；油灰及其他类似胶粘剂；墨水、油墨,3205,色淀；本章注释3所述的以色淀为基本成分的制品,1,61203840,11224872,72428712
32 ,第32章  鞣料浸膏及染料浸膏；鞣酸及其衍生物；染料、颜料及其他着色料；油漆及清漆；油灰及其他类似胶粘剂；墨水、油墨,3206,其他着色料；本章注释3所述的制品，但品目3203、3204及3205的货品除外；用作发光体的无机产品，不论是否已有化学定义,11,4407995970,22901092453,27309088423
32 ,第32章  鞣料浸膏及染料浸膏；鞣酸及其衍生物；染料、颜料及其他着色料；油漆及清漆；油灰及其他类似胶粘剂；墨水、油墨,3207,陶瓷、搪瓷及玻璃工业用的调制颜料、遮光剂、着色剂、珐琅和釉料、釉底料（泥釉）、光瓷釉以及类似产品；搪瓷玻璃料及其他玻璃，呈粉、粒或粉片状,4,981440095,3285864448,4267304543
32 ,第32章  鞣料浸膏及染料浸膏；鞣酸及其衍生物；染料、颜料及其他着色料；油漆及清漆；油灰及其他类似胶粘剂；墨水、油墨,3208,以合成聚合物或化学改性天然聚合物为基本成分的油漆及清漆（包括瓷漆及大漆），分散于或溶于非水介质的；本章注释4所述的溶液,5,5530834099,3106509563,8637343662
32 ,第32章  鞣料浸膏及染料浸膏；鞣酸及其衍生物；染料、颜料及其他着色料；油漆及清漆；油灰及其他类似胶粘剂；墨水、油墨,3209,以合成聚合物或化学改性天然聚合物为基本成分的油漆及清漆（包括瓷漆及大漆），分散于或溶于水介质的,4,1425768836,719846957,2145615793
32 ,第32章  鞣料浸膏及染料浸膏；鞣酸及其衍生物；染料、颜料及其他着色料；油漆及清漆；油灰及其他类似胶粘剂；墨水、油墨,3210,其他油漆及清漆（包括瓷漆、大漆及水浆涂料）；加工皮革用的水性颜料,1,487880323,101154129,589034452
32 ,第32章  鞣料浸膏及染料浸膏；鞣酸及其衍生物；染料、颜料及其他着色料；油漆及清漆；油灰及其他类似胶粘剂；墨水、油墨,3211,配制的催干剂,1,130441200,103291698,233732898
32 ,第32章  鞣料浸膏及染料浸膏；鞣酸及其衍生物；染料、颜料及其他着色料；油漆及清漆；油灰及其他类似胶粘剂；墨水、油墨,3212,制造油漆（含瓷漆）用的颜料（包括金属粉末或金属料片），分散于非水介质中呈液状、浆状的；压印箔；零售形状及零售包装的染料或其他着色料,2,889917707,413034905,1302952612
32 ,第32章  鞣料浸膏及染料浸膏；鞣酸及其衍生物；染料、颜料及其他着色料；油漆及清漆；油灰及其他类似胶粘剂；墨水、油墨,3213,艺术家、学生和广告美工用的颜料、调色料、文娱颜料及类似品，片状、管装、罐装、瓶装、扁盒装以及类似形状或包装,2,76976187,2040342839,2117319026
32 ,第32章  鞣料浸膏及染料浸膏；鞣酸及其衍生物；染料、颜料及其他着色料；油漆及清漆；油灰及其他类似胶粘剂；墨水、油墨,3214,安装玻璃用油灰、接缝用油灰、树脂胶泥、嵌缝胶济其他类似胶粘剂；漆工用填料；非耐火涂面制剂，涂门面、内墙、地板、天花板等用,3,2998773638,2519759503,5518533141
32 ,第32章  鞣料浸膏及染料浸膏；鞣酸及其衍生物；染料、颜料及其他着色料；油漆及清漆；油灰及其他类似胶粘剂；墨水、油墨,3215,印刷油墨、书写或绘图墨水及其他墨类，不论是否固体或浓缩,5,2494316028,2332600721,4826916749
33 ,第33章  精油及香膏；芳香料制品及化妆盥洗品,3301,精油（无萜或含萜），包括浸膏及净油；香膏；提取的油树脂；用花香吸取法或浸渍法制成的含浓缩精油的脂肪、固定油、蜡及类似品；精油脱萜时所得的萜烯副产品；精油水馏液及水溶液,19,1364666358,1681966996,3046633354
33 ,第33章  精油及香膏；芳香料制品及化妆盥洗品,3302,工业原料用的混合香料以及以一种或多种香料为基本成分的混合物（包括酒精溶液）；生产饮料用的以香料为基本成分的其他制品,3,2882720926,2145742807,5028463733
33 ,第33章  精油及香膏；芳香料制品及化妆盥洗品,3303,香水及花露水,1,5717033379,1200006778,6917040157
33 ,第33章  精油及香膏；芳香料制品及化妆盥洗品,3304,美容品或化妆品及护肤品（药品除外），包括防晒油或晒黑油；指（趾）甲化妆品,5,89279339683,13759346487,1.03039E+11
33 ,第33章  精油及香膏；芳香料制品及化妆盥洗品,3305,护发品,4,4596234176,2294829584,6891063760
33 ,第33章  精油及香膏；芳香料制品及化妆盥洗品,3306,口腔及牙齿清洁剂，包括假牙稳固剂及粉；清洁牙缝用的纱线（牙线），单独零售包装的,5,1255600701,3249725089,4505325790
33 ,第33章  精油及香膏；芳香料制品及化妆盥洗品,3307,剃须用制剂、人体除臭剂、泡澡用制剂、脱毛剂和其他品目未列名的芳香料制品及化妆盥洗品；室内除臭剂，不论是否加香水或消毒剂,6,2203690181,13212193332,15415883513
34 ,第34章  肥皂、有机表面活性剂、洗涤剂、润滑剂、人造蜡、调制蜡、光洁剂、蜡烛及类似品、塑型用膏、“牙科用蜡”及牙科用熟石膏制剂,3401,肥皂；作肥皂用的有机表面活性产品及制品，条状、块状或模制形状的，不论是否含有肥皂；洁肤用的有机表面活性产品及制品，液状或膏状冰制成零售包装的，不论是否含有肥皂；用肥皂或洗涤浸渍、涂面或包覆的纸、絮胎、毡呢及无纺织物,5,9098839530,5101952261,14200791791
34 ,第34章  肥皂、有机表面活性剂、洗涤剂、润滑剂、人造蜡、调制蜡、光洁剂、蜡烛及类似品、塑型用膏、“牙科用蜡”及牙科用熟石膏制剂,3402,有机表面活性剂（肥皂除外）；表面活性剂制品、洗涤剂（包括助洗剂）及清洁剂，不论是否含有肥皂，但品目3401的产品除外,8,8572964042,16546316722,25119280764
34 ,第34章  肥皂、有机表面活性剂、洗涤剂、润滑剂、人造蜡、调制蜡、光洁剂、蜡烛及类似品、塑型用膏、“牙科用蜡”及牙科用熟石膏制剂,3403,润滑剂（包括以润滑剂为基本成分的切削油制剂、螺栓或螺母松开剂、防锈或防腐蚀制剂及脱模剂）及用于纺织材料、皮料、毛皮或其他材料油脂处理的制剂，但不包括以石油或从沥青矿物提取的油料为基本成分（按重量计不低于70%）的制剂,4,9966314197,1867145192,11833459389
34 ,第34章  肥皂、有机表面活性剂、洗涤剂、润滑剂、人造蜡、调制蜡、光洁剂、蜡烛及类似品、塑型用膏、“牙科用蜡”及牙科用熟石膏制剂,3404,人造蜡及调制蜡,2,3048120829,2119900700,5168021529
34 ,第34章  肥皂、有机表面活性剂、洗涤剂、润滑剂、人造蜡、调制蜡、光洁剂、蜡烛及类似品、塑型用膏、“牙科用蜡”及牙科用熟石膏制剂,3405,鞋靴、家具、地板、车身、玻璃或金属用的光洁剂、擦洗膏、去污粉及类似制品（包括经这类制剂浸渍、涂面或包覆的纸、絮胎、毡呢、无纺织物、泡沫塑料或海绵橡胶），但不包括品目3404的蜡,5,3040995239,690534237,3731529476
34 ,第34章  肥皂、有机表面活性剂、洗涤剂、润滑剂、人造蜡、调制蜡、光洁剂、蜡烛及类似品、塑型用膏、“牙科用蜡”及牙科用熟石膏制剂,3406,各种蜡烛及类似品,1,206314898,6909785778,7116100676
34 ,第34章  肥皂、有机表面活性剂、洗涤剂、润滑剂、人造蜡、调制蜡、光洁剂、蜡烛及类似品、塑型用膏、“牙科用蜡”及牙科用熟石膏制剂,3407,塑型用膏，包括供儿童娱乐用的在内；通常为“牙科用蜡”或“牙科造型膏”的制品，成套、零售包装或制成片状、马蹄形、条状及类似形状的；以熟石膏（煅石膏或硫酸钙）为基本成分的牙科用其他制品,3,248794536,2143291554,2392086090
35 ,第35章  蛋白类物质；改性淀粉；胶；酶,3501,酪蛋白、酪蛋白酸盐及其他酪蛋白衍生物；酪蛋白胶,2,2166987833,29809109,2196796942
35 ,第35章  蛋白类物质；改性淀粉；胶；酶,3502,白蛋白（包括按重量计干质成分的乳清蛋白含量超过80%的两种或两种以上的乳清蛋白浓缩物）、白蛋白盐及其他白蛋白衍生物,4,2341286853,53127539,2394414392
35 ,第35章  蛋白类物质；改性淀粉；胶；酶,3503,明胶（包括长方形、正方形明胶薄片，不论是否表面加工或着色）及其衍生物；鱼胶；其他动物胶，但不包括品目3501的酪蛋白胶,2,165834451,1585192290,1751026741
35 ,第35章  蛋白类物质；改性淀粉；胶；酶,3504,蛋白胨及其衍生物；其他品目未列名的蛋白质及其衍生物；皮粉，不论是否加入铬矾,2,780194725,4557029106,5337223831
35 ,第35章  蛋白类物质；改性淀粉；胶；酶,3505,糊精及其他改性淀粉（例如，预凝化淀粉或酯化淀粉）；淀粉、糊精或其他改性淀粉为基本成分的胶,2,2863453798,921401411,3784855209
35 ,第35章  蛋白类物质；改性淀粉；胶；酶,3506,其他品目未列名的调制胶及其他调制粘合剂；适于作胶或粘合剂用的产品，零售包装每件净重≤1kg,5,12785175673,14347749512,27132925185
35 ,第35章  蛋白类物质；改性淀粉；胶；酶,3507,酶；其他品目未列名的酶制品,4,2078309373,2766763131,4845072504
36 ,第36章  炸药；烟火制品；引火合金；易燃材料制品,3601,发射药,1,59721602,66471984,126193586
36 ,第36章  炸药；烟火制品；引火合金；易燃材料制品,3602,配制炸药， 但发射药除外,2,34116,46936019,46970135
36 ,第36章  炸药；烟火制品；引火合金；易燃材料制品,3603,安全导火索；导爆索；火帽或雷管；引爆器；电雷管,6,431148968,136090371,567239339
36 ,第36章  炸药；烟火制品；引火合金；易燃材料制品,3604,烟花、爆竹、信号弹、降雨火箭、浓雾信号弹及其他烟火制品,2,11247751,6041924098,6053171849
36 ,第36章  炸药；烟火制品；引火合金；易燃材料制品,3605,火柴， 但品目3604的烟火制品除外,1,91776,37108720,37200496
36 ,第36章  炸药；烟火制品；引火合金；易燃材料制品,3606,各种形状的铈铁及其他引火合金；本章注释2所述的易燃材料制品,4,32045702,123583269,155628971
37 ,第37章  照相及电影用品,3701,未曝光的摄影感光硬片及平面软片，用纸、纸板及纺织物以外任何材料制成；未曝光的一次成像感光平面软片，不论是否分装,11,2311247012,4768836901,7080083913
37 ,第37章  照相及电影用品,3702,成卷的未曝光摄影感光卷片，用纸、纸板及纺织物以外任何材料制成；成卷的未曝光一次成像感光胶片,31,3184480934,745490916,3929971850
37 ,第37章  照相及电影用品,3703,未曝光的摄影感光纸、纸板及纺织物,6,62073262,321848393,383921655
37 ,第37章  照相及电影用品,3704,已曝光未冲洗的摄影硬片、软片、纸、纸板及纺织物,2,97578,1266919,1364497
37 ,第37章  照相及电影用品,3705,已曝光已冲洗的摄影硬片及软片，但电影胶片除外,4,223246689,3335136,226581825
37 ,第37章  照相及电影用品,3706,已曝光已冲洗的电影胶片，不论是否配有声道或仅有声道,4,817948,0,817948
37 ,第37章  照相及电影用品,3707,摄影用化学制剂（不包括上光漆、胶水、粘合剂及类似制剂）；摄影用未混合产品，定量包装或零售包装可立即使用的,4,11784606600,1357891335,13142497935
38 ,第38章  杂项化学产品,3801,人造石墨；胶态或半胶态石墨；以石墨或其他碳为基本成分的糊状、块状、板状制品或半制品,5,2054241597,9357366778,11411608375
38 ,第38章  杂项化学产品,3802,活性碳；活性天然矿产品；动物炭黑，包括废动物炭黑,3,1103649403,3527422258,4631071661
38 ,第38章  杂项化学产品,3803,妥尔油，不论是否精炼,1,67143678,1396949,68540627
38 ,第38章  杂项化学产品,3804,木桨残余碱液，不论是否浓缩、脱糖或经化学处理的，包括木素磺酸盐、但不包括品目3803的妥儿油,1,231736051,232612252,464348303
38 ,第38章  杂项化学产品,3805,脂松节油、木松节油和硫酸盐松节油及其他萜烯油，用蒸馏或其他方法从针叶木制得；粗制二聚戊烯；亚硫酸盐松节油及其他粗制对异丙基苯甲烷；以α萜品醇为基本成分的松节油,3,53113687,64660637,117774324
38 ,第38章  杂项化学产品,3806,松香和树脂酸及衍生物；松香精及松香油；再熔胶,6,669466378,1084961450,1754427828
38 ,第38章  杂项化学产品,3807,木焦油；精制木焦油；木杂酚油；粗木精；植物沥青；以松香、树脂酸或植物沥青为基本成分的啤酒桶沥青及类似制品,1,12771085,18121033,30892118
38 ,第38章  杂项化学产品,3808,杀虫剂、杀鼠剂、杀菌剂、除草剂、抗萌剂、植物生长调节剂、消毒剂及类似产品，零售形状、零售包装或制成制剂及成品（例如，经琉璜处理的带子、杀虫灯芯、蜡烛及捕蝇纸）,19,4791796996,58901019551,63692816547
38 ,第38章  杂项化学产品,3809,纺织、造纸、制革及类似工业用的其他品目未列名的整理剂、染料加速着色或固色助剂及其他产品和制剂（例如，休整剂及媒染剂）,4,2299139154,896139327,3195278481
38 ,第38章  杂项化学产品,3810,金属表面酸洗剂；焊接用的焊剂及其他辅助剂；金属及其他材料制成的焊粉或焊管；作焊条芯子或焊条涂料用的制品,2,1374907300,959345421,2334252721
38 ,第38章  杂项化学产品,3811,抗震剂、抗氧剂、防胶剂、粘度改良剂、防腐蚀制剂及其他配置添加剂，用于矿物油（包括汽油）或与矿物油同样用途的其他液体,5,6371914167,3251300159,9623214326
38 ,第38章  杂项化学产品,3812,配制的橡胶促进剂；其他品目未列名的橡胶或塑料用复合增塑剂；橡胶或塑料用抗氧剂及其他复合稳定剂,5,2360854210,7121314269,9482168479
38 ,第38章  杂项化学产品,3813,灭火器的装配药；已装药的灭火弹,2,52336285,258258372,310594657
38 ,第38章  杂项化学产品,3814,其他品目未列名的有机复合溶剂及稀释剂；除漆剂,1,688483992,244623921,933107913
38 ,第38章  杂项化学产品,3815,其他品目未列名的反应引发剂、反应促进剂、催化剂,4,13896074818,4737437116,18633511934
38 ,第38章  杂项化学产品,3816,耐火的水泥、灰泥、混凝土及类似耐火混合制品，包括夯混白云石，但品目38.01的产品除外,2,218186780,2582879162,2801065942
38 ,第38章  杂项化学产品,3817,混合烷基苯及混合烷基萘，但品目2707及2902的货品除外,1,284567060,1817598689,2102165749
38 ,第38章  杂项化学产品,3818,经掺杂用于电子工业的化学元素，已切成圆片、薄片或类似形状；经掺杂用于电子工业的化合物,3,16043430157,29975432171,46018862328
38 ,第38章  杂项化学产品,3819,闸用液压油及其他液压传动用液体，不含石油或从沥青矿物提取的油类，或者按重量计石油或从沥青矿物提取的油类含量＜70％,1,331917349,117564975,449482324
38 ,第38章  杂项化学产品,3820,防冻剂及解冻剂,1,158226388,106974906,265201294
38 ,第38章  杂项化学产品,3821,制成的供微生物（包括病毒及类似品）或植物、人体、动物细胞生长或维持用的培养基,1,2252092031,452391940,2704483971
38 ,第38章  杂项化学产品,3822,附于衬背上的诊断或实验用试剂及不论是否附于衬背上的诊断或实验用配制试剂，不论是否制成试剂盒形式，但品目30.06的货品除外；有证标准样品,5,27484078014,66104646995,93588725009
38 ,第38章  杂项化学产品,3823,工业用单羧脂肪酸；精炼所得的酸性油；工业用脂肪醇,5,16779741746,640804752,17420546498
38 ,第38章  杂项化学产品,3824,铸模及铸芯用粘合剂；其他品目未列名的化学工业及其相关工业的化学产品及配制品（包括由天然产品混合组成的）,24,36784337486,37131890636,73916228122
38 ,第38章  杂项化学产品,3825,其他品目未列名的化学工业及其相关工业的副产品；城市垃圾；下水道淤泥；本章注释6所规定的其他废物,9,13604465,108310042,121914507
38 ,第38章  杂项化学产品,3826,生物柴油及其混合物，不含或含有按重量计低于70％的石油或从沥青矿物提取的油类,1,2213954406,15190762525,17404716931
38 ,第38章  杂项化学产品,3827,其他品目未列名的含甲烷、乙烷或丙烷的卤化衍生物的混合物,19,10444674,3660315979,3670760653
39 ,第39章  塑料及其制品,3901,初级形状的乙烯聚合物,8,1.1609E+11,13403606909,1.29494E+11
39 ,第39章  塑料及其制品,3902,初级形状的丙烯或其他烯烃聚合物,5,32615584176,11308735983,43924320159
39 ,第39章  塑料及其制品,3903,初级形状的苯乙烯聚合物,7,25913588694,5739723898,31653312592
39 ,第39章  塑料及其制品,3904,初级形状的氯乙烯或其他卤化烯烃聚合物,10,7080169774,23821173326,30901343100
39 ,第39章  塑料及其制品,3905,初级形状的乙酸乙烯酯或其他乙烯酯聚合物；初级形状的其他乙烯基聚合物,7,3163350220,5494539649,8657889869
39 ,第39章  塑料及其制品,3906,初级形状的丙烯酸聚合物,4,12534623781,10218997451,22753621232
39 ,第39章  塑料及其制品,3907,初级形状的聚缩醛、其他聚醚及环氧树脂；初级形状的聚碳酸酯、醇酸树脂、聚烯丙基酯及其他聚酯,17,50677177553,60794545311,1.11472E+11
39 ,第39章  塑料及其制品,3908,初级形状的聚酰胺,7,11300298295,9441440651,20741738946
39 ,第39章  塑料及其制品,3909,初级形状的氨基树脂、酚醛树脂及聚氨酯,6,9567135265,18729567325,28296702590
39 ,第39章  塑料及其制品,3910,初级形状的聚硅氧烷,1,4670885634,11432110916,16102996550
39 ,第39章  塑料及其制品,3911,初级形状的石油树脂、苯并呋喃-茚树脂、多萜树脂、多硫化物、聚砜及本章注释3所规定的其他品目未列名产品,3,4511872551,6306714655,10818587206
39 ,第39章  塑料及其制品,3912,初级形状的其他品目未列名的纤维素及其化学衍生物,6,2476674164,5986994440,8463668604
39 ,第39章  塑料及其制品,3913,初级形状的其他品目未列名的天然聚合物（例如藻酸）及改性天然聚合物（例如，硬化蛋白、天然橡胶的化学衍生物）,2,1326130847,4743328440,6069459287
39 ,第39章  塑料及其制品,3914,初级形状的离子交换剂，以品目3901至3913的聚合物为基本成分的,1,1336860602,1761543995,3098404597
39 ,第39章  塑料及其制品,3915,塑料的废料、下脚料及碎料,5,0,571535491,571535491
39 ,第39章  塑料及其制品,3916,塑料单丝（截面直径＞1mm）、条、杆、型材及异型材，不论是否经表面加工，但未经其他加工,5,725154650,4558903710,5284058360
39 ,第39章  塑料及其制品,3917,塑料制的管子及其附件（例如，接头、肘管、法兰）,10,6997528050,20796615414,27794143464
39 ,第39章  塑料及其制品,3918,块状或成卷的塑料铺地制品，不论是否胶粘；本章注释9所规定的塑料糊墙品,4,395546793,41704903974,42100450767
39 ,第39章  塑料及其制品,3919,自粘的塑料板、片、膜、箔、带、扁条及其他扁平形状材料，不论是否成卷,5,15880739934,31095678456,46976418390
39 ,第39章  塑料及其制品,3920,其他非泡沫塑料的板、片、膜、箔及扁条，为用其他材料强化、层压、支撑或用类似方法合制,22,36419163922,57885535246,94304699168
39 ,第39章  塑料及其制品,3921,其他塑料板、片、膜、箔、扁条,11,7654722399,19065341950,26720064349
39 ,第39章  塑料及其制品,3922,塑料浴缸、淋浴盘、洗涤槽、盥洗盆、坐浴盆、便盆、马桶座圈及盖、抽水箱及类似卫生浴具,3,219475952,7634458600,7853934552
39 ,第39章  塑料及其制品,3923,供运输或包装货物用的塑料制品；塑料制的塞子、盖子及类似品,7,6416505965,73736366396,80152872361
39 ,第39章  塑料及其制品,3924,塑料制的餐具、厨房用具、其他家庭用具及卫生或盥洗用具,2,894935326,82920797131,83815732457
39 ,第39章  塑料及其制品,3925,其他品目未列名的建筑用塑料制品,4,177676051,14824773408,15002449459
39 ,第39章  塑料及其制品,3926,其他塑料制品及品目3901至3914所列其他材料的制品,8,21137219071,1.68966E+11,1.90103E+11
40 ,第40章  橡胶及其制品,4001,天然橡胶、巴拉塔胶、古塔波胶、银胶菊胶、糖胶树胶及类似的天然树胶，初级形状或板、片、带,5,19544108278,248804006,19792912284
40 ,第40章  橡胶及其制品,4002,合成橡胶及从油类提取的油膏，初级形状或板、片、带；品目4001所列产品与本品目所列产品的混合物，初级形状或板、片、带,31,43557276912,8733071865,52290348777
40 ,第40章  橡胶及其制品,4003,再生橡胶，初级形状或板、片、带,1,451728124,448075459,899803583
40 ,第40章  橡胶及其制品,4004,橡胶（硬质橡胶除外）的废料、下脚料及碎料及其粉、粒,1,0,72405680,72405680
40 ,第40章  橡胶及其制品,4005,未硫化的复合橡胶，初级形状或板、片、带,4,1677828107,577804762,2255632869
40 ,第40章  橡胶及其制品,4006,其他形状（例如，杆、管或型材及异型材）的未硫化橡胶及未硫化橡胶制品（例如，盘、环）,3,63432199,75735642,139167841
40 ,第40章  橡胶及其制品,4007,硫化橡胶线及绳,1,1707191593,645420251,2352611844
40 ,第40章  橡胶及其制品,4008,硫化橡胶（硬质橡胶除外）制的板、片、带、杆或型材及异型材,4,997727287,3717297508,4715024795
40 ,第40章  橡胶及其制品,4009,硫化橡胶（硬质橡胶除外）制的管子，不论是否装有附件（例如，接头、肘管、法兰）,8,2725020025,6900114627,9625134652
40 ,第40章  橡胶及其制品,4010,硫化橡胶制的输送带或传动带及带料,10,1180387948,6995797640,8176185588
40 ,第40章  橡胶及其制品,4011,新的充气橡胶轮胎,13,4449141874,94170410629,98619552503
40 ,第40章  橡胶及其制品,4012,翻新的或旧的充气橡胶轮胎；实心或半实心橡胶轮胎、橡胶胎面及橡胶轮胎衬带,9,289569638,916270487,1205840125
40 ,第40章  橡胶及其制品,4013,橡胶内胎,4,12902603,3329221402,3342124005
40 ,第40章  橡胶及其制品,4014,硫化橡胶（硬质橡胶除外）制的卫生及医疗用品（包括奶嘴），不论是否装有硬质橡胶制的附件,2,615479336,970702008,1586181344
40 ,第40章  橡胶及其制品,4015,硫化橡胶（硬质橡胶除外）制的衣着用品及附件（包括分指手套、连指手套及露指手套）,4,2389858027,10517855886,12907713913
40 ,第40章  橡胶及其制品,4016,硫化橡胶（硬质橡胶除外）的其他制品,10,11532198259,18508710190,30040908449
40 ,第40章  橡胶及其制品,4017,各种形状的硬质橡胶（例如、纯硬质胶），包括废料及碎料；硬质橡胶制品,2,39078260,273092841,312171101
41 ,第41章  生皮（毛皮除外）及皮革,4101,生牛皮（包括水牛皮）、生马科动物皮（鲜的、盐腌的、干的、石灰浸渍的、浸酸的或以其他方法保藏、但未鞣制、未经羊皮纸化处理或进一步加工的），不论是否去毛或刨层,9,5584085238,65032708,5649117946
41 ,第41章  生皮（毛皮除外）及皮革,4102,绵羊或羔羊生皮（鲜的、盐腌的、干的、石灰浸渍的、浸酸的或以其他方法保藏、但未鞣制、未经羊皮纸化处理或进一步加工的），不论是否去毛或刨层，但本章注释1（3）所述不包括的生皮除外,5,1111003629,172304066,1283307695
41 ,第41章  生皮（毛皮除外）及皮革,4103,其他生皮（鲜的、盐腌的、干的、石灰浸渍的、浸酸的或以其他方法保藏、但未鞣制、未经羊皮纸化处理或进一步加工的），不论是否去毛或刨层，但本章注释1（2）或（3）所述不包括的生皮除外,7,32997446,465666,33463112
41 ,第41章  生皮（毛皮除外）及皮革,4104,经鞣制的不带毛牛皮（包括水牛皮）、马科动物皮及其坯革，不论是否剖层，但未经进一步加工,9,4883582239,296862691,5180444930
41 ,第41章  生皮（毛皮除外）及皮革,4105,经鞣制的不带毛绵羊或羔羊皮及其坯革，不论是否剖层，但未经进一步加工,3,48112344,268494398,316606742
41 ,第41章  生皮（毛皮除外）及皮革,4106,经鞣制的其他不带毛动物皮及其坯革，不论是否剖层，但未经进一步加工,8,271377139,68856315,340233454
41 ,第41章  生皮（毛皮除外）及皮革,4107,经鞣制或半硝处理后进一步加工的牛皮革（包括水牛皮）及马科动物皮革，包括羊皮纸化处理的皮革，不论是否剖层，但品目4114的皮革除外,10,3907563050,3679903743,7587466793
41 ,第41章  生皮（毛皮除外）及皮革,4112,经鞣制或半硝处理后进一步加工的不带毛的绵羊或羔羊皮革，包括羊皮纸化处理的，不论是否剖层，但品目4114的皮革除外,1,187565303,103171170,290736473
41 ,第41章  生皮（毛皮除外）及皮革,4113,鞣制或半硝处理后进一步加工的不带毛的其他动物皮革，包括羊皮纸化处理的，不论是否剖层，但品目4114的皮革除外,4,312189855,223443542,535633397
41 ,第41章  生皮（毛皮除外）及皮革,4114,油鞣皮革（包括结合鞣制的油鞣皮革）；漆皮及层压漆皮；镀金属皮革,2,198130010,71024725,269154735
41 ,第41章  生皮（毛皮除外）及皮革,4115,以皮革或皮革纤维为基本成分的再生皮革、成块、成张或成条，不论是否成卷；皮革或再生皮革的边角废料，不适宜作皮革制品用；皮革粉末,2,93001480,120436274,213437754
42 ,第42章  皮革制品；鞍具及挽具；旅行用品、手提包及类似容器；动物肠线（蚕胶丝除外）制品,4201,各种材料制成的鞍具及挽具（包括缰绳、挽绳、护膝垫、口套、鞍褥、马褡裢、狗外套及类似品），适合各种动物用,1,58064786,7001059696,7059124482
42 ,第42章  皮革制品；鞍具及挽具；旅行用品、手提包及类似容器；动物肠线（蚕胶丝除外）制品,4202,衣箱、提箱、小手袋、公文箱、公文包、书包、眼镜盒、望远镜盒、照相机套、乐器盒、枪套及类似容器；旅行包、食品或饮料保温包、化妆包、帆布包、手提包、购物袋、钱夹、钱包、地图盒、烟盒、烟袋、工具包、运动包、瓶盒、首饰盒、粉盒、刀叉餐具盒及类似容器，用皮革或再生皮革、塑料片、纺织材料、钢纸或纸板制成，或者全部或主要用上述材料或纸包覆制成,14,27930437330,1.70765E+11,1.98696E+11
42 ,第42章  皮革制品；鞍具及挽具；旅行用品、手提包及类似容器；动物肠线（蚕胶丝除外）制品,4203,皮革或再生皮革制的衣服及衣着附件,7,1996058201,5642206592,7638264793
42 ,第42章  皮革制品；鞍具及挽具；旅行用品、手提包及类似容器；动物肠线（蚕胶丝除外）制品,4205,皮革或再生皮革的其他制品,3,658925796,3109961462,3768887258
42 ,第42章  皮革制品；鞍具及挽具；旅行用品、手提包及类似容器；动物肠线（蚕胶丝除外）制品,4206,肠线（蚕胶丝除外）、肠膜、膀胱或筋腱制品,1,1230991,2087509,3318500
43 ,第43章  毛皮、人造毛皮及其制品,4301,生毛皮（包括适合加工皮货用的头、尾、抓及其他块、片），但品目4101、4102或4103的生皮除外,7,202966060,2108394,205074454
43 ,第43章  毛皮、人造毛皮及其制品,4302,未缝制或已缝制（不加其他材料）的已鞣毛皮（包括头、尾、爪及其他块、片），但品目4303的货品除外,8,1123097337,596252019,1719349356
43 ,第43章  毛皮、人造毛皮及其制品,4303,毛皮制的衣服、衣着附件及其他物品,3,363839521,8102339560,8466179081
43 ,第43章  毛皮、人造毛皮及其制品,4304,人造毛皮及其制品,2,42838222,287339182,330177404
44 ,第44章  木及木制品；木炭,4401,薪柴（圆木段、块、枝、成捆或类似形状）；木片或木粒；锯末、木废料及碎片，不论是否粘结成圆木段、块、片或类似形状,9,19668767205,81211799,19749979004
44 ,第44章  木及木制品；木炭,4402,木炭（包括果壳炭及果核炭），不论是否结块,3,922890330,885688148,1808578478
44 ,第44章  木及木制品；木炭,4403,原木，不论是否去皮、去边材或粗锯成方,39,43988962858,117648272,44106611130
44 ,第44章  木及木制品；木炭,4404,箍木；木劈条；已削尖但未纵锯的木桩；粗加修整但未车圆、弯曲或其他方式加工的木棒、适合制手杖、伞柄、工具把柄及类似品；木片条及类似品,2,14862586,37505876,52368462
44 ,第44章  木及木制品；木炭,4405,木丝；木粉,1,5615201,7758914,13374115
44 ,第44章  木及木制品；木炭,4406,铁道及电车道枕木,4,9278,5768871,5778149
44 ,第44章  木及木制品；木炭,4407,经纵锯、纵切、刨切或旋切的木材，不论是否刨平、砂光或端部接合，厚度＞6mm,31,37890294608,876777245,38767071853
44 ,第44章  木及木制品；木炭,4408,饰面用单板（包括刨切积层木获得的单板）、制胶合板或类似多层板用单板以及其他经纵锯、刨切或旋切的木材，不论是否刨平、砂光、拼接或端部接合，厚≤6mm,20,2071940908,3491916917,5563857825
44 ,第44章  木及木制品；木炭,4409,任何一边、端或面制成连续形状（舌榫、槽榫、半槽榫、斜角、V形接头、珠榫、缘饰、刨圆及类似形状）的木材（包括未装拼得拼花地板用条及缘板），不论其任何一边或面是否刨平、砂光或端部接合,8,1092166718,1181142487,2273309205
44 ,第44章  木及木制品；木炭,4410,碎料板、定向刨花板（OSB）及类似板（例如，华夫板），木或其他木质材料制，不论是否用树脂或其他有机粘合剂粘合,6,2271368515,2091860200,4363228715
44 ,第44章  木及木制品；木炭,4411,木纤维板或其他木质材料纤维板，不论是否用树脂或其他有机粘合剂粘合,25,527688876,6093176954,6620865830
44 ,第44章  木及木制品；木炭,4412,胶合板、单板饰面板及类似的多层板,30,947693261,28513026315,29460719576
44 ,第44章  木及木制品；木炭,4413,强化木，成块、板、条或异型的,1,44798970,71250873,116049843
44 ,第44章  木及木制品；木炭,4414,木制的画框、相框、镜框及类似品,3,10544673,2347429167,2357973840
44 ,第44章  木及木制品；木炭,4415,包装木箱、木盒、板条箱、圆桶及类似的包装容器；木制电缆卷筒；木托板、箱形托盘及其他装载用木板；木制的托盘护框,3,120927394,888881439,1009808833
44 ,第44章  木及木制品；木炭,4416,木制的大桶、琵琶桶、盆和其他箍桶及其零件，包括桶板,2,169078595,24771427,193850022
44 ,第44章  木及木制品；木炭,4417,木制的工具、工具支架、工具柄、扫帚及刷子的身和柄；木制鞋靴楦及楦头,2,8229378,829609395,837838773
44 ,第44章  木及木制品；木炭,4418,建筑用木工制品，包括蜂窝结构木镶板、已装拼的地板、木瓦及盖屋板,21,489410793,7352781912,7842192705
44 ,第44章  木及木制品；木炭,4419,木制餐具及厨房用具,7,157614712,7481949272,7639563984
44 ,第44章  木及木制品；木炭,4420,镶嵌木（包括细工镶嵌木）；装珠宝或刀具用的木制盒子和小匣子及类似品；木制小雕像及其他装饰品；第九十四章以外的木制家具,9,143633594,8265628207,8409261801
44 ,第44章  木及木制品；木炭,4421,其他木制品,6,1856908993,21825078694,23681987687
45 ,第45章  软木及软木制品,4501,未加工或简单加工的天然软木；软木废料；碎的、粒状的或粉状的软木,3,42415226,7297141,49712367
45 ,第45章  软木及软木制品,4502,天然软木、除去表皮或粗切成方形，或成长方块、正方块、板、片或条状（包括做塞子用的方块坯料）,1,344854,215111,559965
45 ,第45章  软木及软木制品,4503,天然软木制品,2,35268459,14994639,50263098
45 ,第45章  软木及软木制品,4504,压制软木（不论是否使用粘合剂压成）及其制品,2,129855105,178542857,308397962
46 ,第46章  稻草、秸秆、针茅或其他编结材料制品；篮筐及柳条编结品,4601,用编结材料编成的缏条及类似产品，不论是否缝合成宽条；平行连结或编结的成片编结材料、缏条或类似的编结材料产品，不论是否制成品（例如，席子、席料、帘子）,17,36126851,2063361784,2099488635
46 ,第46章  稻草、秸秆、针茅或其他编结材料制品；篮筐及柳条编结品,4602,用编结材料直接编成或用品目4601所列货品制成的篮筐、柳条编结品及其他制品；丝瓜络制品,7,95669310,7604606409,7700275719
47 ,第47章  木浆及其他纤维状纤维素浆；回收（废碎）纸及纸板,4701,机械木浆,1,18535472,4894498,23429970
47 ,第47章  木浆及其他纤维状纤维素浆；回收（废碎）纸及纸板,4702,化学木浆、溶解级,1,17617278916,950657,17618229573
47 ,第47章  木浆及其他纤维状纤维素浆；回收（废碎）纸及纸板,4703,烧碱木浆或硫酸盐木浆，但溶解级的除外,4,79239204097,1123852093,80363056190
47 ,第47章  木浆及其他纤维状纤维素浆；回收（废碎）纸及纸板,4704,亚硫酸盐木浆，但溶解级的除外,4,92093804,862767,92956571
47 ,第47章  木浆及其他纤维状纤维素浆；回收（废碎）纸及纸板,4705,用机械与化学联合制浆法制得的木浆,1,3876689775,42830760,3919520535
47 ,第47章  木浆及其他纤维状纤维素浆；回收（废碎）纸及纸板,4706,从回收（废料）纸或纸板提取的纤维浆其他纤维状纤维素浆,6,6316271978,1004573135,7320845113
47 ,第47章  木浆及其他纤维状纤维素浆；回收（废碎）纸及纸板,4707,回收（废碎）纸或纸板,4,682675102,0,682675102
48 ,第48章  纸及纸板；纸浆、纸或纸板制品,4801,成卷或成张的新闻纸,2,1653582968,97299418,1750882386
48 ,第48章  纸及纸板；纸浆、纸或纸板制品,4802,书写、印刷或类似用途的未经涂布的纸及纸板、未打孔的穿孔卡片纸及穿孔纸带纸、成卷或成张矩形（包括正方形），任何尺寸，但品目4801或4803的纸除外；手工制纸及纸板,13,2231342197,5879497728,8110839925
48 ,第48章  纸及纸板；纸浆、纸或纸板制品,4803,卫生纸、面巾纸、餐巾纸以及家庭或卫生用的类似纸、纤维素絮纸和纤维素纤维网纸，不论是否起纹、压花、打孔、染面、饰面或印花，成卷或成张的,1,142905470,1191354855,1334260325
48 ,第48章  纸及纸板；纸浆、纸或纸板制品,4804,成卷或成张的其他未经涂布的牛皮纸及纸板，但不包括品目4802或4803的货品,12,5321842090,940052860,6261894950
48 ,第48章  纸及纸板；纸浆、纸或纸板制品,4805,成卷或成张的其他未经涂布的纸及纸板，加工程度不超过本章注释3所列范围,12,14870203566,4689100508,19559304074
48 ,第48章  纸及纸板；纸浆、纸或纸板制品,4806,成卷或成张的植物羊皮纸、防油纸、描图纸、半透明纸及其他高光泽透明或半透明纸,4,358941465,1322214555,1681156020
48 ,第48章  纸及纸板；纸浆、纸或纸板制品,4807,成卷或成张的复合纸及纸板（用粘合剂粘合各层纸或纸板制成），未经表面涂布或未浸渍，不论内层是否有加强材料,1,102929081,98944526,201873607
48 ,第48章  纸及纸板；纸浆、纸或纸板制品,4808,成卷成张的瓦楞纸及纸板（不论是否与平面纸胶合）、皱纹纸及纸板、压纹纸及纸板、穿孔纸及纸板，但品目4803的纸除外,3,213333866,566130350,779464216
48 ,第48章  纸及纸板；纸浆、纸或纸板制品,4809,复写纸、自印复写纸及其他拷贝或转印纸（包括涂布或浸渍的油印蜡纸或胶印版纸），不论是否印制，成卷或成张的,2,37995786,1412878094,1450873880
48 ,第48章  纸及纸板；纸浆、纸或纸板制品,4810,成卷或成张矩形（包括正方形）的任何尺寸的单面或双面涂布高岭土或其他无机物质（不论是否加粘合剂）的纸及纸板，但未涂布其他涂料，不论是否染面、饰面或印花,10,4267266611,22422815333,26690081944
48 ,第48章  纸及纸板；纸浆、纸或纸板制品,4811,成卷或成张矩形（包括正方形）的任何尺寸的经涂布、浸渍、覆盖、染面、饰面或印花的纸、纸板、纤维素絮纸及纤维素纤维网纸，但品目4803、4809或4810的货品除外,12,2605678138,15691588159,18297266297
48 ,第48章  纸及纸板；纸浆、纸或纸板制品,4812,纸浆制的滤块、滤板及滤片,1,57537004,12395340,69932344
48 ,第48章  纸及纸板；纸浆、纸或纸板制品,4813,卷烟纸，不论是否切成一定尺寸、成小本或管状,3,274386692,841690040,1116076732
48 ,第48章  纸及纸板；纸浆、纸或纸板制品,4814,壁纸及类似品；窗用透明纸,2,95765178,2125478210,2221243388
48 ,第48章  纸及纸板；纸浆、纸或纸板制品,4816,复写纸、自印复写纸及其他拷贝或转印纸（不包括品目4809的纸），油印蜡纸或胶印版纸，不论是否盒装,3,31144505,990112657,1021257162
48 ,第48章  纸及纸板；纸浆、纸或纸板制品,4817,纸或纸板制的信封、封缄信片、素色明信片及通信卡片；纸或纸板制的盒子、袋子及夹子，内装各种纸制文具,3,18394468,1496871530,1515265998
48 ,第48章  纸及纸板；纸浆、纸或纸板制品,4818,卫生纸及类似纸、家庭或卫生用纤维素絮纸及纤维素纤维网纸，成卷宽度不超过36厘米或切成一定尺寸或形状的；纸浆、纸、纤维素絮纸或纤维素纤维网纸制的手帕、面巾、台布、餐巾、床单及类似的家庭、卫生或医院用品、衣服及衣着附件,5,177504352,10828940969,11006445321
48 ,第48章  纸及纸板；纸浆、纸或纸板制品,4819,纸、纸板、纤维素絮纸或纤维素纤维网纸制的箱、盒、匣、袋及其他包装容器；纸或纸板制的卷宗盒、信件盘及类似品，供办公室、商店及类似场所使用的,6,563105503,37795620021,38358725524
48 ,第48章  纸及纸板；纸浆、纸或纸板制品,4820,纸或纸板制的登记本、帐本、笔记本、订货本、收据本、信笺本、记事本、日记本及类似品、练习本、吸墨纸本、活动封面（活页及非活页）、文件夹、卷宗皮、多联商业表格纸、页间夹有复写纸的本及其他文具用品；纸或纸板制的样品簿、粘贴簿及书籍封面,6,99576268,10361393996,10460970264
48 ,第48章  纸及纸板；纸浆、纸或纸板制品,4821,纸或纸板制的各种标签，不论是否印制,2,752555590,6536877821,7289433411
48 ,第48章  纸及纸板；纸浆、纸或纸板制品,4822,纸浆、纸或纸板（不论是否穿孔或硬化）制的筒管、卷轴、纡子及类似品,2,31966482,378860264,410826746
48 ,第48章  纸及纸板；纸浆、纸或纸板制品,4823,切成一定尺寸或形状的其他纸、纸板、纤维素絮纸及纤维素纤维网纸；纸浆、纸、纸板、纤维素絮纸及纤维素纤维网纸制的其他物品,10,917750567,27790949852,28708700419
49 ,第49章  书籍、报纸、印刷图画及其他印刷品；手稿、打字稿及设计图纸,4901,书籍、小册子、散页印刷品及类似印刷品，不论是否单张,3,1766449170,6397630295,8164079465
49 ,第49章  书籍、报纸、印刷图画及其他印刷品；手稿、打字稿及设计图纸,4902,报纸、杂志及期刊，不论有无插图或广告材料,2,1226728136,34227469,1260955605
49 ,第49章  书籍、报纸、印刷图画及其他印刷品；手稿、打字稿及设计图纸,4903,儿童图画书、绘画或涂色书,1,8344012,3994022807,4002366819
49 ,第49章  书籍、报纸、印刷图画及其他印刷品；手稿、打字稿及设计图纸,4904,乐谱原稿或印本，不论是否装订或印有插图,1,6428808,3510454,9939262
49 ,第49章  书籍、报纸、印刷图画及其他印刷品；手稿、打字稿及设计图纸,4905,各种印刷的地图、水道图及类似图表，包括地图册、挂图、地形图及地球仪、天体仪,2,10500347,38892337,49392684
49 ,第49章  书籍、报纸、印刷图画及其他印刷品；手稿、打字稿及设计图纸,4906,手绘的建筑、工程、工业、商业、地形或类似用途的设计图纸原稿；手稿；用感光纸照相复印或用复写纸誊写的上述物品复制件,1,7566839,17798847,25365686
49 ,第49章  书籍、报纸、印刷图画及其他印刷品；手稿、打字稿及设计图纸,4907,在承认或将承认其面值的国家流通或新发行并且未经使用的邮票、印花税票及类似票证；印有邮票或印花税票的纸品；钞票；空白支票；股票、债券及类似所有权凭证,4,5838561680,304196058,6142757738
49 ,第49章  书籍、报纸、印刷图画及其他印刷品；手稿、打字稿及设计图纸,4908,转印贴花纸（移画印花法用图案纸）,2,679881637,1438647815,2118529452
49 ,第49章  书籍、报纸、印刷图画及其他印刷品；手稿、打字稿及设计图纸,4909,印刷或有图画明信片；印有个人问候、祝贺、通告的卡片，不论是否有图片、带信封或饰边,2,16127002,2875551229,2891678231
49 ,第49章  书籍、报纸、印刷图画及其他印刷品；手稿、打字稿及设计图纸,4910,印刷的各种日历，包括日历芯,1,4486169,826515591,831001760
49 ,第49章  书籍、报纸、印刷图画及其他印刷品；手稿、打字稿及设计图纸,4911,其他印刷品，包括印刷的图片及照片,5,1768768648,6399685248,8168453896
50 ,第50章  蚕丝,5001,适于缫丝的蚕茧,2,46484650,6244919,52729569
50 ,第50章  蚕丝,5002,生丝（未加捻）,6,56141875,1442297638,1498439513
50 ,第50章  蚕丝,5003,废丝（包括不适于缫丝的蚕茧、废纱及回收纤维）,5,185709752,188775607,374485359
50 ,第50章  蚕丝,5004,丝纱线（绢纺纱线除外），非供零售用,1,4043559,374790811,378834370
50 ,第50章  蚕丝,5005,绢纺纱线，非供零售用,2,7036472,400563049,407599521
50 ,第50章  蚕丝,5006,丝纱线及绢纺纱线，供零售用；蚕胶丝,1,709827,1229607,1939434
50 ,第50章  蚕丝,5007,丝或绢丝机织物,11,66537332,2321373547,2387910879
51 ,第51章  羊毛、动物细毛或粗毛；马毛纱线及其机织物,5101,未梳的羊毛,5,11340656235,124401372,11465057607
51 ,第51章  羊毛、动物细毛或粗毛；马毛纱线及其机织物,5102,未梳的动物细毛或粗毛,6,2368190404,2198764,2370389168
51 ,第51章  羊毛、动物细毛或粗毛；马毛纱线及其机织物,5103,羊毛及动物细毛或粗毛的废料，包括废纱线，但不包括回收纤维,5,24389220,65257203,89646423
51 ,第51章  羊毛、动物细毛或粗毛；马毛纱线及其机织物,5104,羊毛及动物细毛或粗毛的回收纤维,2,0,1886625,1886625
51 ,第51章  羊毛、动物细毛或粗毛；马毛纱线及其机织物,5105,已梳的羊毛及动物细毛或粗毛（包括精梳片毛）,9,333118124,5014535998,5347654122
51 ,第51章  羊毛、动物细毛或粗毛；马毛纱线及其机织物,5106,粗梳羊毛纱线，非供零售用,2,119850460,600373425,720223885
51 ,第51章  羊毛、动物细毛或粗毛；马毛纱线及其机织物,5107,精梳羊毛纱线，非供零售用,2,231980650,1359671183,1591651833
51 ,第51章  羊毛、动物细毛或粗毛；马毛纱线及其机织物,5108,动物细毛（粗梳或精梳）纱线，非供零售用,6,208780292,2256491857,2465272149
51 ,第51章  羊毛、动物细毛或粗毛；马毛纱线及其机织物,5109,羊毛或动物细毛的纱线，供零售用,6,11751579,109512376,121263955
51 ,第51章  羊毛、动物细毛或粗毛；马毛纱线及其机织物,5110,动物粗毛或马毛的纱线（包括马毛粗松螺旋化纤），不论是否供零售商用,1,148907,700217,849124
51 ,第51章  羊毛、动物细毛或粗毛；马毛纱线及其机织物,5111,粗梳羊毛或粗梳动物细毛的机织物,9,411572114,593476959,1005049073
51 ,第51章  羊毛、动物细毛或粗毛；马毛纱线及其机织物,5112,精梳羊毛或精梳动物细毛的机织物,5,1327848164,1103656495,2431504659
51 ,第51章  羊毛、动物细毛或粗毛；马毛纱线及其机织物,5113,动物粗毛或马毛机织物,1,755185,11747374,12502559
52 ,第52章  棉花,5201,未梳的棉花,1,24878034422,543809321,25421843743
52 ,第52章  棉花,5202,废棉（包括废棉纱线及回收纤维）,3,0,4863882,4863882
52 ,第52章  棉花,5203,已梳的棉花,1,83868295,153197,84021492
52 ,第52章  棉花,5204,棉制缝纫线，不论是否供零售用,3,3024675,138548036,141572711
52 ,第52章  棉花,5205,棉纱线（缝纫线除外），按重量计含棉量≥85％，非供零售用,24,18734597111,4856360594,23590957705
52 ,第52章  棉花,5206,棉纱线（缝纫线除外），按重量计含棉量＜85％，非供零售用,20,957451625,1818582597,2776034222
52 ,第52章  棉花,5207,棉纱线（缝纫线除外），供零售用,2,17549335,165213216,182762551
52 ,第52章  棉花,5208,棉机织物，按重量计含棉量≥85％，每平方米重量≤200g,20,563474714,30213917627,30777392341
52 ,第52章  棉花,5209,棉机织物，按重量计含棉量≥85％，每平方米重量＞200g,16,964043337,11738999440,12703042777
52 ,第52章  棉花,5210,棉机织物，按重量计含棉量＜85％， 主要或仅与化学纤维混纺，每平方米重≤200g,15,191697184,4616691979,4808389163
52 ,第52章  棉花,5211,棉机织物，按重量计含棉量＜85％， 主要或仅与化学纤维混纺，每平方米重＞200g,14,325584046,13759400364,14084984410
52 ,第52章  棉花,5212,其他棉机织物,10,60616782,564922137,625538919
53 ,第53章  其他植物纺织纤维；纸纱线及其机织物,5301,亚麻，生的或已经加工但未纺制的；亚麻短纤及废麻（包括废麻纱线及回收纤维）,4,3310036181,2959047,3312995228
53 ,第53章  其他植物纺织纤维；纸纱线及其机织物,5302,大麻，生的或已经加工但未纺制的；大麻短纤及废麻（包括废麻纱线及回收纤维）,2,11630119,12642412,24272531
53 ,第53章  其他植物纺织纤维；纸纱线及其机织物,5303,黄麻及其他纺织用韧皮纤维（不包括亚麻、大麻及苎麻），生的或经加工但未纺制的；上述纤维的短纤、落麻及废料（包括废纱及回收纤维）,2,71576195,258711,71834906
53 ,第53章  其他植物纺织纤维；纸纱线及其机织物,5305,椰壳纤维、蕉麻（马尼拉麻）、苎麻及其他品目未列名的纺织用植物纤维，生的或经加工但未纺制的；上述纤维的短纤、落麻及废料（包括废纱线及回收纤维）,8,1145020152,11171577,1156191729
53 ,第53章  其他植物纺织纤维；纸纱线及其机织物,5306,亚麻纱线,2,9706985,1569535127,1579242112
53 ,第53章  其他植物纺织纤维；纸纱线及其机织物,5307,黄麻纱线或品目5303的其他纺织用韧皮纤维纱线,2,703643048,43243140,746886188
53 ,第53章  其他植物纺织纤维；纸纱线及其机织物,5308,其他植物纺织纤维纱线；纸纱线,8,21952855,165494718,187447573
53 ,第53章  其他植物纺织纤维；纸纱线及其机织物,5309,亚麻机织物,6,132507981,4443631652,4576139633
53 ,第53章  其他植物纺织纤维；纸纱线及其机织物,5310,黄麻或品目5303的其他纺织韧皮纤维机织物,2,42986430,25119444,68105874
53 ,第53章  其他植物纺织纤维；纸纱线及其机织物,5311,其他纺织用植物纤维机织物；纸纱线机织物,7,6864379,460305751,467170130
54 ,第54章  化学纤维长丝；化学纤维纺织材料制扁条及类似品,5401,化学纤维长丝纺制的缝纫线，不论是否供零售用,4,175701091,2158401416,2334102507
54 ,第54章  化学纤维长丝；化学纤维纺织材料制扁条及类似品,5402,合成纤维长丝纱线（缝纫线除外），非供零售用，包括细度＜67分特的合成纤维单丝,48,5244107199,38864680635,44108787834
54 ,第54章  化学纤维长丝；化学纤维纺织材料制扁条及类似品,5403,人造纤维长丝纱线（缝纫线除外），非供零售用，包括习度＜67分特的人造纤维单丝,11,575210789,3390725444,3965936233
54 ,第54章  化学纤维长丝；化学纤维纺织材料制扁条及类似品,5404,截面尺寸≤1mm，细度≥67分特的合成纤维单丝；表观宽度≤5mm的合成纤维纺织材料制扁条及类似品（例如，人造草）,4,722250821,1491266820,2213517641
54 ,第54章  化学纤维长丝；化学纤维纺织材料制扁条及类似品,5405,截面尺寸≤1mm，细度≥67分特的人造纤维单丝；表观宽度≤5mm的人造纤维纺织材料制扁条及类似品（例如，人造草）,1,5266165,14955720,20221885
54 ,第54章  化学纤维长丝；化学纤维纺织材料制扁条及类似品,5406,化学纤维长丝纱线（缝纫线除外），供零售用,2,6188291,437042523,443230814
54 ,第54章  化学纤维长丝；化学纤维纺织材料制扁条及类似品,5407,合成纤维长丝纱线的机织物，包括品目5404所列材料的机织物,26,4452957136,1.00417E+11,1.0487E+11
54 ,第54章  化学纤维长丝；化学纤维纺织材料制扁条及类似品,5408,人造纤维长丝纱线的机织物，包括品目5405所列材料的机织物,17,418736024,1322622956,1741358980
55 ,第55章  化学纤维短纤,5501,合成纤维长丝丝束,6,201457645,1020936310,1222393955
55 ,第55章  化学纤维短纤,5502,人造纤维长丝丝束,3,161082141,566601965,727684106
55 ,第55章  化学纤维短纤,5503,合成纤维短纤，未梳或未经其他纺前加工,9,2613428135,7282893794,9896321929
55 ,第55章  化学纤维短纤,5504,人造纤维短纤，未梳或未经其他纺前加工,5,2678497937,3520752474,6199250411
55 ,第55章  化学纤维短纤,5505,化学纤维废料（包括落绵、废纱及回收纤维）,2,0,8211484,8211484
55 ,第55章  化学纤维短纤,5506,合成纤维短纤，已梳或经其他纺前加工,9,70985318,149849543,220834861
55 ,第55章  化学纤维短纤,5507,人造纤维短纤，已梳或经其他纺前加工,1,23801334,24738922,48540256
55 ,第55章  化学纤维短纤,5508,化学纤维短纤纺制的缝纫线，不论是否供零售用,2,12334366,2322771511,2335105877
55 ,第55章  化学纤维短纤,5509,合成纤维短纤纱线（缝纫线除外），非供零售用,18,485452515,10276885164,10762337679
55 ,第55章  化学纤维短纤,5510,人造纤维短纤纺制的纱线（缝纫线除外），非供零售用,5,56857516,3651913519,3708771035
55 ,第55章  化学纤维短纤,5511,化学纤维短纤纺制的纱线（缝纫线除外），供零售用,3,952019,279318827,280270846
55 ,第55章  化学纤维短纤,5512,合成纤维短纤纺制的机织物，按重量计合成纤维短纤含量≥85%,6,911071708,6046101827,6957173535
55 ,第55章  化学纤维短纤,5513,合成纤维短纤纺制的机织物，按重量计合成纤维短纤含量＜85%，主要或仅与棉混纺，每平方米重≤170g,19,99963121,8782861274,8882824395
55 ,第55章  化学纤维短纤,5514,合成纤维短纤纺制的机织物，按重量计合成纤维短纤含量＜85%，主要或仅与棉混纺，每平方米重＞170g,19,158718664,3450777167,3609495831
55 ,第55章  化学纤维短纤,5515,合成纤维短纤纺制的其他机织物,9,270644375,9544442133,9815086508
55 ,第55章  化学纤维短纤,5516,人造纤维短纤纺制的机织物,20,150945884,16797750869,16948696753
56 ,第56章  絮胎、毡呢及无纺织物；特种纱线；线、绳、索、缆及其制品,5601,纺织材料絮胎及其制品；长度不超过５毫米的纺织纤维(纤维屑)、纤维粉末及球结,5,579519039,2400036872,2979555911
56 ,第56章  絮胎、毡呢及无纺织物；特种纱线；线、绳、索、缆及其制品,5602,毡呢，不论是否浸渍、涂布、包覆或层压,4,301523057,1315444767,1616967824
56 ,第56章  絮胎、毡呢及无纺织物；特种纱线；线、绳、索、缆及其制品,5603,无纺织物，不论是否浸渍、涂布、包覆或层压,16,4526440515,19881028760,24407469275
56 ,第56章  絮胎、毡呢及无纺织物；特种纱线；线、绳、索、缆及其制品,5604,用纺织材料包覆的橡胶线及绳；用橡胶或塑料浸渍、涂布、包裹或套裹的纺织纱线及品目5404或5405的扁条及类似品,2,97160264,1986308220,2083468484
56 ,第56章  絮胎、毡呢及无纺织物；特种纱线；线、绳、索、缆及其制品,5605,含金属纱线，不论是否螺旋花线，由纺织纱线或品目5404或5405的扁条及类似品与金属线、扁条或粉末混合制的或用金属包覆制得,1,25506391,431364232,456870623
56 ,第56章  絮胎、毡呢及无纺织物；特种纱线；线、绳、索、缆及其制品,5606,粗松螺旋花线，品目5404或5405的扁条及类似品制的螺旋花线（品目5405的货品及马毛粗松螺旋花线除外）；绳绒线（包括植绒绳绒线）；纵行起圈纱线,1,37200419,1039602969,1076803388
56 ,第56章  絮胎、毡呢及无纺织物；特种纱线；线、绳、索、缆及其制品,5607,线、绳、索、缆，不论是否编织或编结而成，也不论是否用橡胶或塑料浸渍、涂布、包覆或套裹,7,416855551,5142589920,5559445471
56 ,第56章  絮胎、毡呢及无纺织物；特种纱线；线、绳、索、缆及其制品,5608,线、绳或索结制的网料；纺织材料制成的渔网及其他网,3,52701369,4826576757,4879278126
56 ,第56章  絮胎、毡呢及无纺织物；特种纱线；线、绳、索、缆及其制品,5609,用纱线、品目5404或5405的扁条及类似品或线、绳、索、缆制成的其他品目未列名物品,1,55592065,2495097212,2550689277
57 ,第57章  地毯及纺织材料的其他铺地制品,5701,结织栽绒地毯及纺织材料的其他结织栽绒铺地制品，不论是否制成的,4,36601555,412285668,448887223
57 ,第57章  地毯及纺织材料的其他铺地制品,5702,机织地毯及纺织材料的其他机织铺地制品，未簇绒或未植绒，不论是否制成的，包括“开来姆”、“苏麦克”、“卡拉马尼”及类似的手织地毯,14,210362436,2578764356,2789126792
57 ,第57章  地毯及纺织材料的其他铺地制品,5703,簇绒地毯及纺织材料的其他簇绒铺地制品，不论是否制成的,6,186448230,7130525743,7316973973
57 ,第57章  地毯及纺织材料的其他铺地制品,5704,毡呢地毯及纺织材料的其他毡呢铺地制品，未簇绒或未植绒，不论是否制成的,3,10428691,104577015,115005706
57 ,第57章  地毯及纺织材料的其他铺地制品,5705,其他地毯及纺织材料的其他铺地制品，不论是否制成的,3,42067461,8634227135,8676294596
58 ,第58章  特种机织物；簇绒织物；花边；装饰毯；装饰带；刺绣品,5801,起绒机织物及绳绒织物，但品目5802或5806的织物除外,15,188663419,5742615465,5931278884
58 ,第58章  特种机织物；簇绒织物；花边；装饰毯；装饰带；刺绣品,5802,毛巾织物及类似的毛圈机织物，但品目5806的狭幅织物除外；簇绒织物，但品目5703的产品除外,11,56694252,278624408,335318660
58 ,第58章  特种机织物；簇绒织物；花边；装饰毯；装饰带；刺绣品,5803,纱罗，但品目5806的狭幅织物除外,4,5826320,61319440,67145760
58 ,第58章  特种机织物；簇绒织物；花边；装饰毯；装饰带；刺绣品,5804,网眼薄纱及其他网眼织物，但不包括机织物、针织物或钩编织物；成卷、成条或成小块图案的花边，但品目6002至6006的织物除外,9,298900857,4974296552,5273197409
58 ,第58章  特种机织物；簇绒织物；花边；装饰毯；装饰带；刺绣品,5805,“哥白林”、“弗朗德”、“奥步生”、“波威”及类似式样的手织装饰毯，以及手工针绣嵌花装饰毯（例如，小针脚或十字绣），不论是否制成的,2,219260,8362636,8581896
58 ,第58章  特种机织物；簇绒织物；花边；装饰毯；装饰带；刺绣品,5806,狭幅机织物，但品目5807的货物除外；用粘合剂粘合制成的有经纱而无纬纱的狭幅织物（包扎匹头用带）,10,745304597,9531794589,10277099186
58 ,第58章  特种机织物；簇绒织物；花边；装饰毯；装饰带；刺绣品,5807,非绣制的纺材料制标签、徽章及类似品，成匹、成条或裁成一定形状或尺寸,2,235977982,2373916994,2609894976
58 ,第58章  特种机织物；簇绒织物；花边；装饰毯；装饰带；刺绣品,5808,成匹的编带；非绣制的成匹装饰带，但针织或钩编的除外；流苏、绒球及类似品,2,33922100,906348815,940270915
58 ,第58章  特种机织物；簇绒织物；花边；装饰毯；装饰带；刺绣品,5809,其他品目未列名的金属线机织物及品目5605所列含金属纱线的有机织物，用于衣着、装饰及类似用途,3,4688219,17853672,22541891
58 ,第58章  特种机织物；簇绒织物；花边；装饰毯；装饰带；刺绣品,5810,成匹、成条或成小块图案的刺绣品,4,78008981,5917547047,5995556028
58 ,第58章  特种机织物；簇绒织物；花边；装饰毯；装饰带；刺绣品,5811,经绗缝或其他方法用一层或几层纺织材料与胎料组合制成的被褥状纺织品，但品目5810的刺绣品除外,5,71301383,471127919,542429302
59 ,第59章  浸渍、涂布、包覆或层压的纺织物；工业用纺织制品,5901,用胶或淀粉物质涂布的纺织物，作书籍封面及类似用途的；描图布；制成的油画布；作帽里的硬衬布及类似硬挺纺织物,7,30642194,1908660619,1939302813
59 ,第59章  浸渍、涂布、包覆或层压的纺织物；工业用纺织制品,5902,尼龙或其他聚酰胺、聚酯或粘胶纤维高强力纱制的帘子布,5,541426410,5150124651,5691551061
59 ,第59章  浸渍、涂布、包覆或层压的纺织物；工业用纺织制品,5903,用塑料浸渍、涂布、包覆或层压的纺织物，但品目5902的货品除外,9,3865106452,35496871219,39361977671
59 ,第59章  浸渍、涂布、包覆或层压的纺织物；工业用纺织制品,5904,列诺伦（亚麻油地毡），不论是否剪切成形；以纺织物为底布经涂布或覆面的铺地制品，不论是否剪切成形,2,19995364,84623943,104619307
59 ,第59章  浸渍、涂布、包覆或层压的纺织物；工业用纺织制品,5905,糊墙织物,1,17231735,175137968,192369703
59 ,第59章  浸渍、涂布、包覆或层压的纺织物；工业用纺织制品,5906,用橡胶处理的纺织物，但品目5902的货品除外,5,478640752,1127013708,1605654460
59 ,第59章  浸渍、涂布、包覆或层压的纺织物；工业用纺织制品,5907,用其他材料浸渍、涂布或包覆的纺织物；作舞台、摄影布景或类似用途的已绘制花布,3,217423049,2073807003,2291230052
59 ,第59章  浸渍、涂布、包覆或层压的纺织物；工业用纺织制品,5908,用纺织材料机织、编结或针织而成的灯芯、炉芯、打火机芯、短芯或类似品；煤气灯纱筒及纱罩，不论是否浸渍,1,12559325,37592215,50151540
59 ,第59章  浸渍、涂布、包覆或层压的纺织物；工业用纺织制品,5909,纺织材料制的水龙软管及类似的管子，不论有无其他材料作衬里、护套或附件,1,31001623,742203315,773204938
59 ,第59章  浸渍、涂布、包覆或层压的纺织物；工业用纺织制品,5910,纺织材料制的传动带或输送带及带料，不论是否用塑料浸渍、涂布、包覆或层压，也不论是否用金属或其他材料加强,1,147347118,624405157,771752275
59 ,第59章  浸渍、涂布、包覆或层压的纺织物；工业用纺织制品,5911,本章注释7所规定的作专门技术用途的纺织产品及制品,7,2289777434,4286588970,6576366404
60 ,第60章  针织物及钩编织物,6001,针织或钩编的起绒织物，包括“长毛绒”织物及毛圈织物,7,596643543,30367108550,30963752093
60 ,第60章  针织物及钩编织物,6002,宽度≤30cm，按重量计弹性纱线或橡胶线含量≥5%的针织物或钩编织物，但品目6001的货品除外,10,24684436,712434917,737119353
60 ,第60章  针织物及钩编织物,6003,宽度≤30cm，含弹性纱线或橡胶线＜5%的针织物或钩编织物，但品目6001或6002的货品除外,5,35917588,295105277,331022865
60 ,第60章  针织物及钩编织物,6004,宽度＞30cm，按重量计弹性纱线或橡胶线含量≥5%的针织物或钩编织物，但品目6001的货品除外,10,1284125402,25123672231,26407797633
60 ,第60章  针织物及钩编织物,6005,经编织物（包括由花边针织机织成的），但品目6001至6004的货品除外,15,693364810,6804312773,7497677583
60 ,第60章  针织物及钩编织物,6006,其他针织物或钩编织物,14,2007473751,59827341362,61834815113
61 ,第61章  针织或钩编的服装及衣着附件,6101,针织或钩编的男式大衣、短大衣、斗篷、短斗篷、带风帽的防寒短上衣（包括滑雪短上衣）、防风衣、防风短上衣及类似品，但品目6103的货品除外,4,252236359,2392937771,2645174130
61 ,第61章  针织或钩编的服装及衣着附件,6102,针织或钩编的女式大衣、短大衣、斗篷、短斗篷、带风帽的防寒短上衣（包括滑雪短上衣）、防风衣、防风短上衣及类似品，但品目6104的货品除外,4,358853240,4005460340,4364313580
61 ,第61章  针织或钩编的服装及衣着附件,6103,针或钩织的男式西服套装、便服套装、上衣、长裤、护胸背带工装裤、马裤及短裤（游泳裤除外）,15,1526830946,33415724568,34942555514
61 ,第61章  针织或钩编的服装及衣着附件,6104,针或钩织的女式西服套装、便服套装、上衣、连衣裙、裙子、裙裤、长裤、护胸背带工装裤、马裤及短裤（游泳裤除外）,25,2696805647,89601382095,92298187742
61 ,第61章  针织或钩编的服装及衣着附件,6105,针织或钩编的男衬衫,3,1301313849,6663929876,7965243725
61 ,第61章  针织或钩编的服装及衣着附件,6106,针织或钩编的女衬衫,3,205975456,2473612363,2679587819
61 ,第61章  针织或钩编的服装及衣着附件,6107,针织或钩编的男式内裤、三角裤、长睡衣、睡衣裤、浴衣、晨衣及类似品,11,307472605,17356302784,17663775389
61 ,第61章  针织或钩编的服装及衣着附件,6108,针织或钩编的女式长衬裙、衬裙、三角裤、短衬裙、睡衣、睡衣裤、浴衣、晨衣及类似品,15,218382332,37052384960,37270767292
61 ,第61章  针织或钩编的服装及衣着附件,6109,针织或钩编的Ｔ恤衫、汗衫及其他背心,3,5226799031,47591784414,52818583445
61 ,第61章  针织或钩编的服装及衣着附件,6110,针织或钩编的套头衫、开襟衫、外穿背心及类似品,9,7305495275,1.13926E+11,1.21232E+11
61 ,第61章  针织或钩编的服装及衣着附件,6111,针织或钩编的婴儿服装及衣着附件,4,267411086,11143077812,11410488898
61 ,第61章  针织或钩编的服装及衣着附件,6112,针织或钩编的运动服、滑雪服及游泳服,9,107189392,12436291227,12543480619
61 ,第61章  针织或钩编的服装及衣着附件,6113,用品目5903、5906或5907的针织物或钩编织物制成的服装,1,33053852,2343664782,2376718634
61 ,第61章  针织或钩编的服装及衣着附件,6114,针织或钩编的其他服装,4,537975595,15814679723,16352655318
61 ,第61章  针织或钩编的服装及衣着附件,6115,针织或钩编的连裤袜、紧身裤袜、长统袜、短袜及其他袜类，包括渐紧压袜类（例如用以治疗静脉曲张的长统袜）和无外绱鞋底的鞋类,10,356128845,35697131847,36053260692
61 ,第61章  针织或钩编的服装及衣着附件,6116,针织或钩编的分指手套、连指手套及露指手套,5,111913113,16592976598,16704889711
61 ,第61章  针织或钩编的服装及衣着附件,6117,其他制成的针织或钩编的衣着附件；服装或衣着附件的针织或钩编零件,7,242632057,9793121698,10035753755
62 ,第62章  非针织或非钩编的服装及衣着附件,6201,男式大衣、短大衣、斗蓬、短斗篷、带风帽的防寒短上衣（包括滑雪短上衣）、防风衣、防风短上衣及类似品，但品目6203的货品除外,6,3683463712,35194862674,38878326386
62 ,第62章  非针织或非钩编的服装及衣着附件,6202,女式大衣、短大衣、斗蓬、短斗篷、带风帽的防寒短上衣（包括滑雪短上衣）、防风衣、防风短上衣及类似品，但品目6204的货品除外,6,4225473446,45072552121,49298025567
62 ,第62章  非针织或非钩编的服装及衣着附件,6203,男式西服套装、便服套装、上衣、长裤、护胸背带工装裤、马裤及短裤（游泳裤除外）,21,3981194193,55849022359,59830216552
62 ,第62章  非针织或非钩编的服装及衣着附件,6204,女式西服套装、便服套装、上衣、连衣裙、裙子、裙裤、长裤、护胸背带工装裤、马裤及短裤（游泳裤除外）,30,6845938029,1.261E+11,1.32946E+11
62 ,第62章  非针织或非钩编的服装及衣着附件,6205,男衬衫,5,1380487659,11167694210,12548181869
62 ,第62章  非针织或非钩编的服装及衣着附件,6206,女衬衫,5,827792735,11110302118,11938094853
62 ,第62章  非针织或非钩编的服装及衣着附件,6207,男式背心及其他内衣、内裤、三角裤、睡衣裤、浴衣、晨衣及类似品,12,28950809,2148278646,2177229455
62 ,第62章  非针织或非钩编的服装及衣着附件,6208,女式背心及其他内衣、长衬裙、衬裙、三角裤、睡衣裤、浴衣、晨衣及类似品,12,116217662,5735317565,5851535227
62 ,第62章  非针织或非钩编的服装及衣着附件,6209,婴儿服装及衣着附件,4,69332490,2233984331,2303316821
62 ,第62章  非针织或非钩编的服装及衣着附件,6210,用品目5602、5603、5903、5906或5907的织物制成的服装,8,585141388,23363417954,23948559342
62 ,第62章  非针织或非钩编的服装及衣着附件,6211,运动服、滑雪服及游泳服；其他服装,19,2635746403,28597652026,31233398429
62 ,第62章  非针织或非钩编的服装及衣着附件,6212,胸罩、腹带、紧身胸衣、吊裤带、吊袜带、束袜带和类似品及其零件，不论是否针织或钩编的,8,725481747,25222248058,25947729805
62 ,第62章  非针织或非钩编的服装及衣着附件,6213,手帕,4,14454935,420763657,435218592
62 ,第62章  非针织或非钩编的服装及衣着附件,6214,披巾、头巾、围巾、披纱、面纱及类似品,7,1231099103,6483748101,7714847204
62 ,第62章  非针织或非钩编的服装及衣着附件,6215,领带及领结,3,75834113,1095794344,1171628457
62 ,第62章  非针织或非钩编的服装及衣着附件,6216,分指手套、连指手套及露指手套,1,55302974,2794328269,2849631243
62 ,第62章  非针织或非钩编的服装及衣着附件,6217,其他制成的衣着附件；服装或衣着附件的零件，但品目6212的货品除外,4,328477862,2437251409,2765729271
63 ,第63章  其他纺织制成品；成套物品；旧衣着及旧纺织品；碎织物,6301,毯子及旅行毯,5,133716321,21315984384,21449700705
63 ,第63章  其他纺织制成品；成套物品；旧衣着及旧纺织品；碎织物,6302,床上、餐桌、 盥洗及厨房用的织物制品,35,269763798,47521705223,47791469021
63 ,第63章  其他纺织制成品；成套物品；旧衣着及旧纺织品；碎织物,6303,窗帘（包括帷帘）及帐幔；帘帷或床帷,9,86265162,14411087787,14497352949
63 ,第63章  其他纺织制成品；成套物品；旧衣着及旧纺织品；碎织物,6304,其他装饰用织物制品，但品目9404的货品除外,25,114315440,11634979414,11749294854
63 ,第63章  其他纺织制成品；成套物品；旧衣着及旧纺织品；碎织物,6305,货物包装用袋,6,109567203,9351263198,9460830401
63 ,第63章  其他纺织制成品；成套物品；旧衣着及旧纺织品；碎织物,6306,油苫布、天蓬及遮阳蓬；帐蓬（包括临时顶篷及类似品）；风帆；野营用品,16,91554028,23296848180,23388402208
63 ,第63章  其他纺织制成品；成套物品；旧衣着及旧纺织品；碎织物,6307,其他制成品，包括服装裁剪样,4,1118126006,58413431615,59531557621
63 ,第63章  其他纺织制成品；成套物品；旧衣着及旧纺织品；碎织物,6308,由机织物及纱线构成的零售包装成套物品，不论是否带附件，用以制作小地毯、装饰毯、绣花台布、餐巾或类似纺织物品,1,2972588,86092501,89065089
63 ,第63章  其他纺织制成品；成套物品；旧衣着及旧纺织品；碎织物,6309,旧衣物,1,0,4630175974,4630175974
63 ,第63章  其他纺织制成品；成套物品；旧衣着及旧纺织品；碎织物,6310,纺织材料的新或旧的碎织物及废线、绳、索、缆及其制品,2,0,194779786,194779786
64 ,第64章  鞋靴、护腿和类似品及其零件,6401,橡胶或塑料制外底及鞋面的防水鞋靴，其鞋面不是用缝、铆、钉、旋、塞或类似方法固定在鞋底上的,5,19287624,4438152671,4457440295
64 ,第64章  鞋靴、护腿和类似品及其零件,6402,橡胶或塑料制外底及鞋面的其他鞋靴,7,4345179220,1.35427E+11,1.39772E+11
64 ,第64章  鞋靴、护腿和类似品及其零件,6403,橡胶、塑料、皮革或再生革制外底，皮革制鞋面的鞋靴,14,13844088464,57775343985,71619432449
64 ,第64章  鞋靴、护腿和类似品及其零件,6404,橡胶、塑料、皮革、或再生皮革制外底，用纺织材料制鞋面的鞋靴,5,11149202198,77933239169,89082441367
64 ,第64章  鞋靴、护腿和类似品及其零件,6405,其他鞋靴,5,314763410,6523825285,6838588695
64 ,第64章  鞋靴、护腿和类似品及其零件,6406,鞋靴零件（包括鞋面，不论是否带有除外底以外的其他鞋底）；活动式鞋内底、跟垫及类似品；护腿、裹腿和类似品及其零件,7,1650820199,21966124337,23616944536
65 ,第65章  帽类及其零件,6501,毡呢制的帽坯、帽身及帽兜，未楦制成形，也未加帽边；毡呢制的圆帽片及制帽用的毡呢筒（包括裁开的毡呢筒）,1,19120,57917414,57936534
65 ,第65章  帽类及其零件,6502,编结的帽坯或用任何材料的条带拼制而成的帽胚，未楦制成形，也未加帽边、衬里或装饰物,1,405656,86645047,87050703
65 ,第65章  帽类及其零件,6504,编结帽或用任何材料的条带拼制而成的帽类,1,19258974,1348311202,1367570176
65 ,第65章  帽类及其零件,6505,针织或钩编的帽类，用成匹的花边、毡呢或其他纺织物（条带除外）制成的帽带，不论有无衬里或装饰物；任何材料制的发网，不论有无衬里或装饰物,4,784993630,18458817573,19243811203
65 ,第65章  帽类及其零件,6506,其他帽类，不论有无衬里或装饰物,5,382289186,13695226523,14077515709
65 ,第65章  帽类及其零件,6507,帽圈、帽衬、帽套、帽帮、帽骨架、帽舌及帽颏带,1,57707392,786344927,844052319
66 ,第66章  雨伞、阳伞、手杖、鞭子、马鞭及其零件,6601,雨伞及阳伞（包括手杖伞、庭园用伞及类似伞）,3,35430536,14782723565,14818154101
66 ,第66章  雨伞、阳伞、手杖、鞭子、马鞭及其零件,6602,手杖、带座手杖、鞭子、马鞭及类似品,1,9509451,1140980707,1150490158
66 ,第66章  雨伞、阳伞、手杖、鞭子、马鞭及其零件,6603,品目6601或6602所列物品的零件及装饰品,2,5029718,1530623145,1535652863
67 ,第67章  已加工羽毛、羽绒及其制品；人造花；人发制品,6701,带羽毛或羽绒的鸟皮及鸟体其他部分、羽毛、部分羽毛、羽绒及其制品（品目0505的货品和经加工的羽管及羽轴除外）,1,10337928,323098744,333436672
67 ,第67章  已加工羽毛、羽绒及其制品；人造花；人发制品,6702,人造花、叶、果实及其零件；用人造花、叶或果实制成的物品,5,14837717,33483027677,33497865394
67 ,第67章  已加工羽毛、羽绒及其制品；人造花；人发制品,6703,经梳理、稀疏、脱色或其他方法加工的人发；作假发及类似用品的羊毛、其他动物毛或其他纺织材料,1,4419130353,334010402,4753140755
67 ,第67章  已加工羽毛、羽绒及其制品；人造花；人发制品,6704,人发、动物毛或纺织材料制的假发、假胡须、假眉毛、假睫毛及类似品；其他品目未列名的人发制品,4,139567552,27266431939,27405999491
68 ,第68章  石料、石膏、水泥、石棉、云母及类似材料的制品,6801,天然石料（不包括板岩）制的长方砌石、路缘石、扁平石,1,338661,1448074690,1448413351
68 ,第68章  石料、石膏、水泥、石棉、云母及类似材料的制品,6802,已加工碑石或建筑用石（不包括板岩）及其制品，但品目6801的货品除外；天然石料（包括板岩）制的镶嵌石（马赛克）及类似品，不论是否有衬背；天然石料（包括板岩）制的人工染色石料、石片及石粉,17,160753910,25834600087,25995353997
68 ,第68章  石料、石膏、水泥、石棉、云母及类似材料的制品,6803,已加工的板岩及板岩或粘聚板岩的制品,2,4764881,891764449,896529330
68 ,第68章  石料、石膏、水泥、石棉、云母及类似材料的制品,6804,未装支架的石磨、石碾、砂轮和类似品及其零件，用于研磨、磨刃、抛光、整形或切割，以及手用磨石、抛光石及其零件，用天然石料、粘聚的天然磨料、人造磨料或陶瓷制成，不论是否装有由其他材料制成的零件,9,2320607325,6457011345,8777618670
68 ,第68章  石料、石膏、水泥、石棉、云母及类似材料的制品,6805,砂布、砂纸及以其他材料为底的类似品，不论是否裁切、缝合或用其他方法加工成形,3,1091295258,3206711560,4298006818
68 ,第68章  石料、石膏、水泥、石棉、云母及类似材料的制品,6806,矿质棉、岩石棉及类似的矿质棉；叶状蛭石、膨胀黏土、泡沫矿渣及类似的膨胀矿物材料；具有隔热、隔音或吸音性能地矿物材料的混合物及制品，但品目6811、6812或第69章的货品除外,4,715917626,2626580810,3342498436
68 ,第68章  石料、石膏、水泥、石棉、云母及类似材料的制品,6807,沥青或类似原料（例如，石油沥青或煤焦油沥青）制品,2,67187467,268192968,335380435
68 ,第68章  石料、石膏、水泥、石棉、云母及类似材料的制品,6808,镶板、平板、瓦、砖及类似品，用水泥、石膏及其他矿物粘合材料粘合植物纤维、稻草、刨花、木片屑、木粉、锯末或木废料制成,1,9538426,805502416,815040842
68 ,第68章  石料、石膏、水泥、石棉、云母及类似材料的制品,6809,石膏制品及以石膏为基本成分的混合材料制品,3,44564137,1014355475,1058919612
68 ,第68章  石料、石膏、水泥、石棉、云母及类似材料的制品,6810,水泥、混凝土或人造石制品，不论是否加强,7,454202594,21352581059,21806783653
68 ,第68章  石料、石膏、水泥、石棉、云母及类似材料的制品,6811,石棉水泥、纤维素水泥或类似材料的制品,8,32345236,845041380,877386616
68 ,第68章  石料、石膏、水泥、石棉、云母及类似材料的制品,6812,已加工石棉纤维；以石棉为基本成分或以石棉和碳酸镁为基本成分的混合物；上述混合物或石棉的制品（例如，纱线、机织物、服装、帽类、鞋靴、衬垫），不论是否加强，但品目6811或6813的货品除外,5,17904062,146666625,164570687
68 ,第68章  石料、石膏、水泥、石棉、云母及类似材料的制品,6813,以石棉、其他矿物质或纤维素为基本成分的未装配摩擦材料及其制品（例如，片、卷、带、盘、圈、垫及扇形），适于作制动器、离合器及类似品，不论是否与织物或其他材料结合而成,4,289712791,452294241,742007032
68 ,第68章  石料、石膏、水泥、石棉、云母及类似材料的制品,6814,已加工的云母及其制品，包括粘聚或复制的云母，不论是否附于纸、纸板或其他材料上,2,95251359,502629761,597881120
68 ,第68章  石料、石膏、水泥、石棉、云母及类似材料的制品,6815,其他品目未列名的石制品及其他矿物制品（包括碳纤维，碳纤维制品和泥煤制品）,9,5683914401,5323420596,11007334997
69 ,第69章  陶瓷产品,6901,硅质化石粉（例如，各种硅藻土）或类似硅土制的砖、块、瓦及其他陶瓷制品,1,12417101,140886978,153304079
69 ,第69章  陶瓷产品,6902,耐火砖、块、瓦及类似耐火陶瓷建材制品，但硅质化石粉及类似硅土制的除外,3,541522756,10435931916,10977454672
69 ,第69章  陶瓷产品,6903,其他耐火陶瓷制品（例如，甑、坩埚、马弗罩、喷管、拴塞、支架、烤体、管子、护套、棒条及滑阀式水口），但硅质化石粉及类似硅土制的除外,3,1010524734,2124252273,3134777007
69 ,第69章  陶瓷产品,6904,陶瓷制建筑用砖、铺地砖、支撑或填充用砖及类似品,2,7710900,8125145059,8132855959
69 ,第69章  陶瓷产品,6905,屋顶瓦、烟囱罩、通风帽、烟囱衬壁、建筑装饰及其他建筑用陶瓷制品,2,14429923,519593538,534023461
69 ,第69章  陶瓷产品,6906,陶瓷套管、导管、槽管及管子配件,1,53854430,101683662,155538092
69 ,第69章  陶瓷产品,6907,陶瓷贴面砖、铺面砖，包括炉面砖及墙面砖；陶瓷镶嵌砖（马赛克）及其类似品，不论是否有衬背；饰面陶瓷,10,768029149,21093022860,21861052009
69 ,第69章  陶瓷产品,6909,实验室、化学或其他技术用陶瓷器；农业用陶瓷槽、缸及类似容器；通常供运输及盛装货物用的陶瓷罐、坛及类似品,4,3540560934,5219780489,8760341423
69 ,第69章  陶瓷产品,6910,陶瓷洗涤槽、脸盆、脸盆座、浴缸、坐浴盆、抽水马桶、水箱、小便池及类似的固定卫生设备,2,528012630,44310957262,44838969892
69 ,第69章  陶瓷产品,6911,瓷餐具、厨房器具及其他家用或盥洗用瓷器,5,486491760,37892425629,38378917389
69 ,第69章  陶瓷产品,6912,陶餐具、厨房器具及其他家用或盥洗用陶器,2,137590987,3310859374,3448450361
69 ,第69章  陶瓷产品,6913,塑像及其他装饰用陶瓷制品,2,126469081,10813818459,10940287540
69 ,第69章  陶瓷产品,6914,其他陶瓷制品,2,1029928072,8043648505,9073576577
70 ,第70章  玻璃及其制品,7001,碎玻璃及废玻璃，来源于阴极射线管或品目85.49的其他活化玻璃除外；玻璃块料,2,445146164,402800217,847946381
70 ,第70章  玻璃及其制品,7002,未加工的玻璃球、棒及管（品目7018的微型玻璃球除外）,7,1393173927,1201561213,2594735140
70 ,第70章  玻璃及其制品,7003,铸制或轧制玻璃板、片或型材及异型材，不论是否有吸收、反射或非反射层，但未经其他加工,4,12311788171,5447672056,17759460227
70 ,第70章  玻璃及其制品,7004,拉制或吹制玻璃板、片，不论是否有吸收、反射或非反射层，但未经其他加工,2,144588467,281516655,426105122
70 ,第70章  玻璃及其制品,7005,浮法玻璃板、片及表面研磨或抛光玻璃板、片，不论是否有吸收、反射或非反射层，但未经其他加工,4,3366569896,10178828342,13545398238
70 ,第70章  玻璃及其制品,7006,经弯曲、磨边、镂刻、钻孔、涂珐琅或其他加工的品目70.03、70.04或70.05的玻璃，但未用其他材料镶框或装配,1,5963457255,3991786121,9955243376
70 ,第70章  玻璃及其制品,7007,钢化或层压玻璃制的安全玻璃,6,737815669,19083268233,19821083902
70 ,第70章  玻璃及其制品,7008,多层隔温、隔音玻璃组件,2,18541395,1587996481,1606537876
70 ,第70章  玻璃及其制品,7009,玻璃镜（包括后视镜），不论是否镶框,3,2136908466,15672998040,17809906506
70 ,第70章  玻璃及其制品,7010,玻璃制的坛、瓶、缸、罐、安瓿及其他容器，用于运输或盛装货物；玻璃制保藏罐；玻璃塞、盖及类似的封口器,6,352437217,15093945976,15446383193
70 ,第70章  玻璃及其制品,7011,制灯泡和光源、阴极射线管及类似品用的未封口玻璃外壳（包括玻璃泡及管）及其玻璃零件，但未装有配件,5,36651107,81166511,117817618
70 ,第70章  玻璃及其制品,7013,玻璃器皿，供餐桌、厨房、盥洗室、办公室、室内装饰或类似用途（品目7010或7018的货品除外）,10,569752137,22925365012,23495117149
70 ,第70章  玻璃及其制品,7014,未经光学加工的信号玻璃器及玻璃制光学元件（品目7015的货品除外）,2,464938403,539747650,1004686053
70 ,第70章  玻璃及其制品,7015,钟表玻璃及类似玻璃、视力矫正或非视力矫正眼镜用玻璃，呈弧面、弯曲、凹形或类似形状但未经光学加工的；制造上述玻璃用的凹面圆形及扇形玻璃,5,112515369,60087728,172603097
70 ,第70章  玻璃及其制品,7016,建筑用压制或模制的铺面用玻璃块、砖、片、瓦及其他制品，不论是否夹丝；供镶嵌或类似装饰用的玻璃马赛克及其他小件玻璃品，不论是否有衬背；花式铅条窗玻璃及类似品；多孔或泡沫玻璃块、板、片及类似品,3,31874451,2870719208,2902593659
70 ,第70章  玻璃及其制品,7017,实验室、卫生及配药用的玻璃器皿，不论有无刻度或标量,3,428089657,790171730,1218261387
70 ,第70章  玻璃及其制品,7018,玻璃珠、仿珍珠、仿宝石或仿半宝石和类似小件玻璃品及其制品，但仿首饰除外；玻璃眼，但医用假眼除外；灯工方法制作的玻璃塑像及其他玻璃装饰品，但仿首饰除外；直径≤的玻璃小珠,3,611169487,7546145439,8157314926
70 ,第70章  玻璃及其制品,7019,玻璃纤维（包括玻璃棉）及其制品（例如，纱线、无捻粗纱及其织物）,34,4576994550,18066057290,22643051840
70 ,第70章  玻璃及其制品,7020,其他玻璃制品,6,3247956739,2744492369,5992449108
71 ,第71章  天然或养殖珍珠、宝石或半宝石、贵金属、包贵金属及其制品；仿首饰；硬币,7101,天然或养殖珍珠，不论是否加工或分级，但未成串或镶嵌；天然或养殖珍珠，为便于运输而暂穿成串,8,353318775,243646869,596965644
71 ,第71章  天然或养殖珍珠、宝石或半宝石、贵金属、包贵金属及其制品；仿首饰；硬币,7102,钻石，不论是否加工，但未镶嵌,5,44133046431,11070485564,55203531995
71 ,第71章  天然或养殖珍珠、宝石或半宝石、贵金属、包贵金属及其制品；仿首饰；硬币,7103,宝石（钻石除外）或半宝石，不论是否加工或分级，但未成串或镶嵌；未分级的宝石（钻石除外）或半宝石，为便于运输而暂穿成串,7,14066495099,1081586872,15148081971
71 ,第71章  天然或养殖珍珠、宝石或半宝石、贵金属、包贵金属及其制品；仿首饰；硬币,7104,合成或再造宝石或半宝石，不论是否加工或分级，但未成串或镶嵌的；未分级的合成或再造宝石或半宝石，为便于运输而暂穿成串,8,1018297435,4244214604,5262512039
71 ,第71章  天然或养殖珍珠、宝石或半宝石、贵金属、包贵金属及其制品；仿首饰；硬币,7105,天然或合成的宝石或半宝石的粉末,3,93871336,1175246443,1269117779
71 ,第71章  天然或养殖珍珠、宝石或半宝石、贵金属、包贵金属及其制品；仿首饰；硬币,7106,银（包括镀金、镀铂的银），未锻造、半制成或粉末状,8,6097249225,13465966883,19563216108
71 ,第71章  天然或养殖珍珠、宝石或半宝石、贵金属、包贵金属及其制品；仿首饰；硬币,7107,以贱金属为底的包银材料,1,100485202,87978675,188463877
71 ,第71章  天然或养殖珍珠、宝石或半宝石、贵金属、包贵金属及其制品；仿首饰；硬币,7108,金（包括镀铂的金），未锻造、半制成或粉末状,4,3.44439E+11,17969716626,3.62408E+11
71 ,第71章  天然或养殖珍珠、宝石或半宝石、贵金属、包贵金属及其制品；仿首饰；硬币,7109,以贱金属或银为底的包金材料,1,6145521,1872928,8018449
71 ,第71章  天然或养殖珍珠、宝石或半宝石、贵金属、包贵金属及其制品；仿首饰；硬币,7110,铂，未锻造、半制成或粉末状,12,41285964926,85523530,41371488456
71 ,第71章  天然或养殖珍珠、宝石或半宝石、贵金属、包贵金属及其制品；仿首饰；硬币,7111,以贱金属、银或金为底的包铂材料,1,82605287,0,82605287
71 ,第71章  天然或养殖珍珠、宝石或半宝石、贵金属、包贵金属及其制品；仿首饰；硬币,7112,贵金属或包贵金属的废料及碎料；含有贵金属或贵金属化合物的其他废料及碎料，主要用于回收贵金属，品目85.49的货品除外,9,118906,438970654,439089560
71 ,第71章  天然或养殖珍珠、宝石或半宝石、贵金属、包贵金属及其制品；仿首饰；硬币,7113,贵金属或包贵金属制的首饰及其零件,8,21388191075,63444023255,84832214330
71 ,第71章  天然或养殖珍珠、宝石或半宝石、贵金属、包贵金属及其制品；仿首饰；硬币,7114,贵金属或包贵金属制的金银器及其零件,3,70183972,1128020751,1198204723
71 ,第71章  天然或养殖珍珠、宝石或半宝石、贵金属、包贵金属及其制品；仿首饰；硬币,7115,贵金属或包贵金属的其他制品,3,1051314227,532620195,1583934422
71 ,第71章  天然或养殖珍珠、宝石或半宝石、贵金属、包贵金属及其制品；仿首饰；硬币,7116,用天然或养殖珍珠、宝石或半宝石（天然、合成或再造）制成的物品,2,433490570,1454036742,1887527312
71 ,第71章  天然或养殖珍珠、宝石或半宝石、贵金属、包贵金属及其制品；仿首饰；硬币,7117,仿首饰,3,1687616324,18567638891,20255255215
71 ,第71章  天然或养殖珍珠、宝石或半宝石、贵金属、包贵金属及其制品；仿首饰；硬币,7118,硬币,2,4403502,11149674,15553176
72 ,第72章  钢铁,7201,生铁及镜铁，锭、块或其他初级形状,3,3665271712,804968375,4470240087
72 ,第72章  钢铁,7202,铁合金,21,98277171726,17086543634,1.15364E+11
72 ,第72章  钢铁,7203,直接从铁矿还原所得的铁产品及其他海绵铁产品，块、团、团粒及类似形状；按重量计纯度≥99.94%的铁，块、团、团粒及类似形状,2,2201763882,305376402,2507140284
72 ,第72章  钢铁,7204,钢铁废料及碎料；供再熔的碎料钢铁锭,7,1363702023,10010623,1373712646
72 ,第72章  钢铁,7205,生铁、镜铁及钢铁的颗粒和粉末,4,1638874464,885851269,2524725733
72 ,第72章  钢铁,7206,铁及非合金钢，锭或其他初级形状（品目7203的铁除外）,2,9438636,0,9438636
72 ,第72章  钢铁,7207,铁及非合金钢的半制成品,4,16891394239,4794913929,21686308168
72 ,第72章  钢铁,7208,宽度≥600mm的铁或非合金钢平板轧材，经热轧，但未经包覆、镀层或涂层,22,11801741166,60460641497,72262382663
72 ,第72章  钢铁,7209,宽度≥600mm的铁或非合金钢平板轧材，经冷轧，但未经包覆、镀层或涂层,13,5759595111,15550640064,21310235175
72 ,第72章  钢铁,7210,宽度≥600mm的铁或非合金钢平板轧材，经包覆、镀层或涂层,12,8247714645,1.03303E+11,1.11551E+11
72 ,第72章  钢铁,7211,宽度＜600mm的铁或非合金钢平板轧材，但未经包覆、镀层或涂层,6,555680459,2917441625,3473122084
72 ,第72章  钢铁,7212,宽度＜600mm的铁或非合金钢平板轧材，经包覆、镀层或涂层,6,1058085437,16534479270,17592564707
72 ,第72章  钢铁,7213,不规则盘卷的铁及非合金钢的热轧条、杆,4,1322891359,9108843706,10431735065
72 ,第72章  钢铁,7214,铁或非合金钢的其他条、杆，除锻造、热轧、热拉杆或热挤压外未经进一步加工，包括压制后扭曲的,5,2161124009,7493926313,9655050322
72 ,第72章  钢铁,7215,铁及非合金钢的其他条、杆,3,544843083,642500417,1187343500
72 ,第72章  钢铁,7216,铁或非合金钢的角材、型材及异型材,20,826177427,15229988912,16056166339
72 ,第72章  钢铁,7217,铁丝或非合金钢丝,5,491219985,25833827537,26325047522
72 ,第72章  钢铁,7218,不锈钢，锭状及其他初级形状；不锈钢半制品,3,18801122067,46,18801122113
72 ,第72章  钢铁,7219,不锈钢平板轧材，宽度≥600mm,25,16943649439,52445019973,69388669412
72 ,第72章  钢铁,7220,不锈钢平板轧材，宽度＜600mm,6,1653728293,8639620053,10293348346
72 ,第72章  钢铁,7221,不规则盘卷的不锈钢热轧条、杆,1,1448482997,1988853932,3437336929
72 ,第72章  钢铁,7222,不锈钢其他条、杆；不锈钢角材、型材及异型材,5,2418071645,2632947098,5051018743
72 ,第72章  钢铁,7223,不锈钢丝,1,919091608,2108528685,3027620293
72 ,第72章  钢铁,7224,其他合金钢，锭状或其他初级形状；其他合金钢制的半制成品,3,1278416461,43119111,1321535572
72 ,第72章  钢铁,7225,其他合金钢平板轧材，宽≥600mm,11,12275952238,27881738797,40157691035
72 ,第72章  钢铁,7226,其他合金钢平板轧材，宽＜600mm,10,1852873729,2344117843,4196991572
72 ,第72章  钢铁,7227,不规则盘卷的其他合金钢热轧条、杆,4,1426991101,3930682038,5357673139
72 ,第72章  钢铁,7228,其他合金钢条、杆；其他合金钢角材、型材及异型材；合金钢或非合金钢制的空心钻钢,10,3339511669,15510045498,18849557167
72 ,第72章  钢铁,7229,其他合金钢丝,3,733071618,2471401618,3204473236
73 ,第73章  钢铁制品,7301,钢铁板桩，不论是否钻孔、打眼或组装；焊接的钢铁角材、型材及异型材,2,132949675,4763055353,4896005028
73 ,第73章  钢铁制品,7302,铁道及电车道铺轨用钢铁材料（钢轨、护轨、齿轨、道岔尖轨、辙叉、尖轨拉杆及其他岔道段体、轨枕、鱼尾板、轨座、轨座楔、钢轨垫板、钢轨夹、底板、固定板及其他专门用于连接或加固路轨的材料）,5,210008241,2336299167,2546307408
73 ,第73章  钢铁制品,7303,铸铁管及空心异型材,2,19519208,2376344596,2395863804
73 ,第73章  钢铁制品,7304,无缝钢铁管及空心异型材（铸铁的除外）,33,3652991044,38918617051,42571608095
73 ,第73章  钢铁制品,7305,其他圆形截面钢铁管（例如，焊、铆及用类似方法接合的管）， 外径≥406.4mm,7,264741140,4641920059,4906661199
73 ,第73章  钢铁制品,7306,其他钢铁管及空心异型材（例如，焊、铆及用类似方法接合的管）,12,1898196699,34681505284,36579701983
73 ,第73章  钢铁制品,7307,钢铁管子附件（例如， 接头、肘管、管套）,10,4681392326,28954902058,33636294384
73 ,第73章  钢铁制品,7308,钢铁结构体（品目9406的活动房屋除外）及其部件（例如，桥梁及桥梁体段、闸门、塔楼、格构杆、屋顶、屋顶框架、门窗及其框架、门槛、百叶窗、栏杆、支柱及立柱）；上述结构体用的已加工钢铁板、杆、角材、型材、异型材、管子及类似品,5,1789156516,92320944419,94110100935
73 ,第73章  钢铁制品,7309,盛装物料用的钢铁槽、罐、桶及类似容器（装压缩气体或液化气体的除外），容积＞300L，不论是否衬里或隔热，但无机械或热力装置,1,938384980,4883806050,5822191030
73 ,第73章  钢铁制品,7310,盛装物料用的钢铁桶、罐、听、盒及类似容器（装压缩气体或液化气体的除外），容积≤300L，不论是否衬里或隔热，但无机械或热力装置,5,623499024,7544590702,8168089726
73 ,第73章  钢铁制品,7311,装压缩气体或液化气体用的钢铁容器,2,469723575,5397270073,5866993648
73 ,第73章  钢铁制品,7312,非绝缘的钢铁绞股线、绳、缆、编带、吊索及类似品,2,1398495238,14199169180,15597664418
73 ,第73章  钢铁制品,7313,带刺钢铁丝；围篱用的钢铁绞带或单股扁丝（不论是否带刺）及松绞的双股丝,1,425174,1615881427,1616306601
73 ,第73章  钢铁制品,7314,钢铁丝制的布（包括环形带）、网、篱、格栅；网眼钢铁板,10,692879490,15473751881,16166631371
73 ,第73章  钢铁制品,7315,钢铁链及其零件,10,1114046916,12048472889,13162519805
73 ,第73章  钢铁制品,7316,钢铁锚、多爪锚及其零件,1,10939973,578124674,589064647
73 ,第73章  钢铁制品,7317,钢铁制钉、平头钉、图钉、波纹钉、U形钉（品目8305的货品除外）及类似品，不论钉头是否用其他材料制成，但不包括铜头钉,1,98039188,10457595366,10555634554
73 ,第73章  钢铁制品,7318,钢铁制的螺钉、螺栓、螺母、方头螺钉、钩头螺钉、铆钉、销、开尾销、垫圈（包括弹簧垫圈）及类似品,13,14254827379,54324846344,68579673723
73 ,第73章  钢铁制品,7319,钢铁制的手工缝针、编织针、引针、钩针、刺绣穿孔锥及类似制品；其他品目未列名的钢铁制安全别针及其他别针,3,48010629,815228463,863239092
73 ,第73章  钢铁制品,7320,钢铁制弹簧及弹簧片,7,2560958953,4377968066,6938927019
73 ,第73章  钢铁制品,7321,非电热的钢铁制家用炉、灶（包括附有集中供暖用的热水锅的炉）、烤肉架、烤炉、煤气灶、加热板和类似非电热的家用器具及其零件,8,232352193,30235783009,30468135202
73 ,第73章  钢铁制品,7322,非电热的钢铁制集中供暖用散热器及其零件；非电热的钢铁制空气加热器、暖气分布器（包括可分布新鲜空气或调节空气的）及其零件，装有电动风扇或鼓风机,3,114371737,1231270119,1345641856
73 ,第73章  钢铁制品,7323,餐桌、厨房用或其他家用钢铁器具及其零件；钢铁丝绒；钢铁制擦锅器、洗刷擦光用的块垫、手套及类似品,8,457949901,57538434908,57996384809
73 ,第73章  钢铁制品,7324,钢铁制卫生器具及其零件,4,136185819,14320208308,14456394127
73 ,第73章  钢铁制品,7325,其他钢铁铸造制品,5,316679135,7090806784,7407485919
73 ,第73章  钢铁制品,7326,其他钢铁制品,8,11145483938,88319890592,99465374530
74 ,第74章  铜及其制品,7401,铜锍；沉积铜（泥铜）,1,639934551,3016,639937567
74 ,第74章  铜及其制品,7402,未精炼铜；电解精炼用的铜阳极,1,55214441461,9498380,55223939841
74 ,第74章  铜及其制品,7403,未锻轧的精炼铜及铜合金,9,1.86372E+11,12729460635,1.99102E+11
74 ,第74章  铜及其制品,7404,铜废料及碎料,1,70877090501,4465715,70881556216
74 ,第74章  铜及其制品,7405,铜母合金,1,1133216257,35684011,1168900268
74 ,第74章  铜及其制品,7406,铜粉及片状粉末,8,1804430936,238757945,2043188881
74 ,第74章  铜及其制品,7407,铜条、杆、型材及异型材,6,1886202069,1079215967,2965418036
74 ,第74章  铜及其制品,7408,铜丝,6,5050328600,3870175087,8920503687
74 ,第74章  铜及其制品,7409,铜板、片及带，厚度＞0.15mm,9,6470608906,5957935992,12428544898
74 ,第74章  铜及其制品,7410,铜箔（不论是否印花或用纸、纸板、塑料或类似材料衬背），厚度（除衬背外）≤0.15mm,7,17793942606,6358914947,24152857553
74 ,第74章  铜及其制品,7411,铜管,8,1405179578,12996926894,14402106472
74 ,第74章  铜及其制品,7412,铜制管子附件（例如， 接头、肘管、管套）,3,723570011,7843855526,8567425537
74 ,第74章  铜及其制品,7413,非绝缘铜丝绞线、缆、编带及类似品,1,517796676,329533990,847330666
74 ,第74章  铜及其制品,7415,铜制或钢铁制带铜头的各种钉、平头钉、图钉、U形钉（品目8305的货品除外）及类似品；铜制螺钉、螺栓、螺母、钩头螺钉、铆钉、销、开尾销、垫圈（包括弹簧垫圈）及类似品,6,548695174,939367919,1488063093
74 ,第74章  铜及其制品,7418,餐桌、厨房或其他家用铜制器具及其零件；铜制擦锅器、洗刷擦光用的块垫、手套及类似品；铜制卫生器具及其零件,4,110321312,2420338560,2530659872
74 ,第74章  铜及其制品,7419,其他铜制品,10,1866626425,1893301073,3759927498
75 ,第75章  镍及其制品,7501,镍锍、氧化镍烧结物及镍冶炼的其他中间产品,3,33902398482,173711632,34076110114
75 ,第75章  镍及其制品,7502,未锻轧镍,3,19765802111,3283214486,23049016597
75 ,第75章  镍及其制品,7503,镍废料及碎料,1,574926,33904026,34478952
75 ,第75章  镍及其制品,7504,镍粉及片状粉末,2,4226428878,748645600,4975074478
75 ,第75章  镍及其制品,7505,镍条、杆、型材及异型材或丝,4,1458082226,692072953,2150155179
75 ,第75章  镍及其制品,7506,镍板、片、带、箔,2,1540225697,557636007,2097861704
75 ,第75章  镍及其制品,7507,镍管及管子附件（例如， 接头、肘管、管套）,3,536732906,418663317,955396223
75 ,第75章  镍及其制品,7508,其他镍制品,6,1223849078,244221584,1468070662
76 ,第76章  铝及其制品,7601,未锻轧铝,3,22619608334,7279594316,29899202650
76 ,第76章  铝及其制品,7602,铝废料及碎料,1,16359917813,12513590,16372431403
76 ,第76章  铝及其制品,7603,铝粉及片状粉末,2,91312940,203971815,295284755
76 ,第76章  铝及其制品,7604,铝条、杆、型材及异型材,5,1469295195,18647407036,20116702231
76 ,第76章  铝及其制品,7605,铝丝,4,369537413,949408091,1318945504
76 ,第76章  铝及其制品,7606,铝板、片及带，厚度＞0.2mm,11,6743610060,69797782907,76541392967
76 ,第76章  铝及其制品,7607,铝箔（不论是否印花或用纸、纸板、塑料或类似材料衬背），厚度（衬背除外）≤0.2mm,5,4690924585,34858272867,39549197452
76 ,第76章  铝及其制品,7608,铝管,4,249470301,3070012781,3319483082
76 ,第76章  铝及其制品,7609,铝制管子附件（例如， 接头、肘管、管套）,1,262907508,1872890013,2135797521
76 ,第76章  铝及其制品,7610,铝制结构体（品目9406的活动房屋除外）及其部件（例如，桥梁及桥梁体段、塔、格构杆、屋顶、屋顶框架、门窗及其框架、门槛、栏杆、支柱及立柱）；上述结构体用的已加工铝板、杆、型材、异型材、管子及类似品,2,515779182,27555939367,28071718549
76 ,第76章  铝及其制品,7611,盛装物料用的铝制槽、罐、桶及类似容器（装压缩气体或液化气体的除外），容积＞300L，不论是否衬里或隔热，但无机械或热力装置,1,323261844,217413426,540675270
76 ,第76章  铝及其制品,7612,盛装物料用的铝制桶、罐、听、盒及类似容器，包括软管容器及硬管容器（装压缩气体或液化气体的除外），容积≤300L，不论是否衬里或隔热，但无机械或热力装置,3,110266603,2364680006,2474946609
76 ,第76章  铝及其制品,7613,装压缩气体或液化气体用的铝制容器,2,67155816,375121131,442276947
76 ,第76章  铝及其制品,7614,非绝缘的铝制绞股线、缆、编带及类似品,2,6392506,2963984119,2970376625
76 ,第76章  铝及其制品,7615,餐桌、厨房用或其他家用铝制器具及其零件；铝制擦锅器、洗刷擦光用的块垫、手套及类似品；铝制卫生器具及其零件,3,282666143,18140553621,18423219764
76 ,第76章  铝及其制品,7616,其他铝制品,4,3107984779,27942474929,31050459708
78 ,第78章  铅及其制品,7801,未锻轧铅,3,380536235,1468556255,1849092490
78 ,第78章  铅及其制品,7802,铅废料及碎料,1,0,0,0
78 ,第78章  铅及其制品,7804,铅板、片、带、箔；铅粉及片状粉末,3,10691923,63004630,73696553
78 ,第78章  铅及其制品,7806,其他铅制品,2,50934135,77498711,128432846
79 ,第79章  锌及其制品,7901,未锻轧锌,4,2533867790,1866419432,4400287222
79 ,第79章  锌及其制品,7902,锌废料及碎料,1,0,3993,3993
79 ,第79章  锌及其制品,7903,锌末、锌粉及片状粉末,2,177968508,26312310,204280818
79 ,第79章  锌及其制品,7904,锌条、杆、型材及异型材或丝,1,15084868,68216305,83301173
79 ,第79章  锌及其制品,7905,锌板、片、带、箔,1,72764673,17816857,90581530
79 ,第79章  锌及其制品,7907,其他锌制品,3,272770720,777542096,1050312816
80 ,第80章  锡及其制品,8001,未锻轧锡,5,5080304426,1791003187,6871307613
80 ,第80章  锡及其制品,8002,锡废料及碎料,1,0,0,0
80 ,第80章  锡及其制品,8003,锡条、杆、型材及异型材或丝,1,364441079,107379003,471820082
80 ,第80章  锡及其制品,8007,其他锡制品,4,241459145,284303384,525762529
81 ,第81章  其他贱金属、金属陶瓷及其制品,8101,钨及其制品，包括废料及碎料,6,215184595,1480896468,1696081063
81 ,第81章  其他贱金属、金属陶瓷及其制品,8102,钼及其制品，包括废料及碎料,6,274626498,972218820,1246845318
81 ,第81章  其他贱金属、金属陶瓷及其制品,8103,钽及其制品，包括废料及碎料,8,658254118,1238854089,1897108207
81 ,第81章  其他贱金属、金属陶瓷及其制品,8104,镁及其制品，包括废料及碎料,6,51257944,14631244492,14682502436
81 ,第81章  其他贱金属、金属陶瓷及其制品,8105,钴锍及其他冶炼钴时所得的中间产品；钴及其制品，包括废料及碎料,5,33552079714,1393154190,34945233904
81 ,第81章  其他贱金属、金属陶瓷及其制品,8106,铋及其制品， 包括废料及碎料,4,22376631,253610755,275987386
81 ,第81章  其他贱金属、金属陶瓷及其制品,8108,钛及其制品，包括废料及碎料,10,3501035575,3780417325,7281452900
81 ,第81章  其他贱金属、金属陶瓷及其制品,8109,锆及其制品，包括废料及碎料,6,110674176,121352484,232026660
81 ,第81章  其他贱金属、金属陶瓷及其制品,8110,锑及其制品，包括废料及碎料,4,58549504,808688637,867238141
81 ,第81章  其他贱金属、金属陶瓷及其制品,8111,锰及其制品，包括废料及碎料,2,661361506,6704629997,7365991503
81 ,第81章  其他贱金属、金属陶瓷及其制品,8112,铍、铬、铪、铼、铊、镉、锗、钒、镓、铟、铌及其制品，包括废料及碎料,26,591456399,2324314062,2915770461
81 ,第81章  其他贱金属、金属陶瓷及其制品,8113,金属陶瓷及其制品，包括废料及碎料,2,537219879,392693526,929913405
82 ,第82章  贱金属工具、器具、利口器、餐匙、餐叉及其零件,8201,锹、铲、镐、锄、叉及耙；斧子、钩刀及类似砍伐工具；各种修枝用剪刀；镰刀、秣刀、树篱剪、伐木楔子及其他农业、园艺或林业用手工工具,7,30663342,6021305179,6051968521
82 ,第82章  贱金属工具、器具、利口器、餐匙、餐叉及其零件,8202,手工锯；各种锯的锯片（包括切条、切槽或无齿锯片）,11,976281155,9136895723,10113176878
82 ,第82章  贱金属工具、器具、利口器、餐匙、餐叉及其零件,8203,钢锉、木锉、钳子（包括剪钳）、镊子、白铁剪、切管器、螺栓切头器、打孔冲子及类似手工工具,4,269775016,5431722996,5701498012
82 ,第82章  贱金属工具、器具、利口器、餐匙、餐叉及其零件,8204,手动扳手及扳钳（包括转矩扳手，但不包括丝锥扳手）；可互换的扳手套筒，不论是否带手柄,3,709480445,6837804987,7547285432
82 ,第82章  贱金属工具、器具、利口器、餐匙、餐叉及其零件,8205,其他处未列名的手工工具（包括玻璃刀）；喷灯；台钳、夹钳及类似品，但作为机床或水射流切割机附件或零件的除外；砧；轻便锻炉；带支架的手摇或脚踏砂轮,9,491665690,20708914524,21200580214
82 ,第82章  贱金属工具、器具、利口器、餐匙、餐叉及其零件,8206,由品目8202至8205中两个或两个以上品目的工具组成的零售包装成套货品,1,114218365,5105703530,5219921895
82 ,第82章  贱金属工具、器具、利口器、餐匙、餐叉及其零件,8207,手工具（不论是否有动力装置）及机床（例如，锻压、冲压、攻丝、钻孔、镗孔、铰孔及铣削、车削或上螺丝用的机器）的可互换工具，包括金属拉拔或挤压用模以及凿岩或钻探工具,17,5764995785,23065978216,28830974001
82 ,第82章  贱金属工具、器具、利口器、餐匙、餐叉及其零件,8208,机器或机械器具的刀及刀片,7,4278230641,3128202038,7406432679
82 ,第82章  贱金属工具、器具、利口器、餐匙、餐叉及其零件,8209,未装配的工具用金属陶瓷板、杆、刀头及类似品,5,1208862950,3749364027,4958226977
82 ,第82章  贱金属工具、器具、利口器、餐匙、餐叉及其零件,8210,用于加工或调制食品或饮料的手动机械器具，重量≤10kg,1,26808773,1598863177,1625671950
82 ,第82章  贱金属工具、器具、利口器、餐匙、餐叉及其零件,8211,有刃口的刀及其刀片，不论是否有锯齿（包括整枝刀），但品目8208的刀除外,6,140514551,8767492046,8908006597
82 ,第82章  贱金属工具、器具、利口器、餐匙、餐叉及其零件,8212,剃刀及其刀片（包括未分开的刀片条）,3,724352597,2716424619,3440777216
82 ,第82章  贱金属工具、器具、利口器、餐匙、餐叉及其零件,8213,剪刀、裁缝剪刀及类似品、剪刀片,1,45425980,3898884273,3944310253
82 ,第82章  贱金属工具、器具、利口器、餐匙、餐叉及其零件,8214,其他利口器（例如，理发推子、屠刀、砍骨刀、切肉刀、切菜刀、裁纸刀）；修指甲或修脚用具（包括指甲锉）,3,109280848,4807760645,4917041493
82 ,第82章  贱金属工具、器具、利口器、餐匙、餐叉及其零件,8215,餐匙、餐叉、长柄勺、漏勺、糕点夹、鱼刀、黄油刀、糖块夹及类似的厨房或餐桌用具,4,70943284,12870020234,12940963518
83 ,第83章  贱金属杂项制品,8301,贱金属制的锁（钥匙锁、数码锁及电动锁）；贱金属制带锁的扣环及扣环框架；上述锁的贱金属制钥匙,8,2324699857,25983671149,28308371006
83 ,第83章  贱金属杂项制品,8302,用于家具、门窗、楼梯、百叶窗、车厢、鞍具、衣箱、盒子及类似品的贱金属附件及架座；贱金属制帽架、帽钩、托架及类似品；用贱金属作支架的小脚轮；贱金属制的自动闭门器,8,4372117145,72998092825,77370209970
83 ,第83章  贱金属杂项制品,8303,装甲或加强的贱金属制保险箱、保险柜及保险库的门和带锁保险储存橱、钱箱、契约箱及类似品,1,21189090,3101092598,3122281688
83 ,第83章  贱金属杂项制品,8304,贱金属制的档案柜、卡片索引柜、文件盘、文件篮、笔盘、公章架及类似的办公用具，但品目9403的办公室家具除外,1,1621443,1108483754,1110105197
83 ,第83章  贱金属杂项制品,8305,活页夹、卷宗夹的贱金属附件、贱金属制的信夹、信角、文件夹、索引标签及类似的办公用品；贱金属制的成条钉书针（例如，供办公室、室内装饰或包装用）,3,24039032,2928411594,2952450626
83 ,第83章  贱金属杂项制品,8306,非电动的贱金属铃、钟、锣及类似品；贱金属雕塑像及其他装饰品；贱金属相框或画框及类似框架；贱金属镜子,5,155164714,9597497032,9752661746
83 ,第83章  贱金属杂项制品,8307,贱金属软管，不论是否有附件,2,635611455,2849121531,3484732986
83 ,第83章  贱金属杂项制品,8308,贱金属制的扣、钩、环、眼及类似品，用于衣着或衣着附件、鞋靴、珠宝首饰、手表、书籍、天篷、皮革制品、旅行用品、马具或其他制成品；贱金属制的管形铆钉及开口铆钉；贱金属制的珠子及亮晶片,3,708697998,7713474439,8422172437
83 ,第83章  贱金属杂项制品,8309,贱金属制的塞子、盖子（包括冠形瓶塞、螺口盖及倒水塞）、瓶帽、螺口塞、塞子帽、封志及其他包装用附件,2,494842843,6968741804,7463584647
83 ,第83章  贱金属杂项制品,8310,贱金属制的标志牌、铭牌、地名牌及类似品、号码、字母及类似标志，但品目9405的货品除外,1,260274241,1638005042,1898279283
83 ,第83章  贱金属杂项制品,8311,贱金属或硬质合金制的丝、条、管、板、电极及类似品，以焊剂涂面或以焊剂为芯，用于焊接或沉积金属、硬质合金；贱金属粉粘聚而成的丝或条，供金属喷镀用,4,994363661,4469995816,5464359477
84 ,第84章  核反应堆、锅炉、机器、机械器具及零件,8401,核反应堆；核反应堆的未辐照燃料元件（释热元件）；同位素分离机器及装置,7,1788761233,208271227,1997032460
84 ,第84章  核反应堆、锅炉、机器、机械器具及零件,8402,蒸汽锅炉（能产生低压水蒸气的集中供暖用的热水锅炉除外）；过热水锅炉,6,293466730,4417886381,4711353111
84 ,第84章  核反应堆、锅炉、机器、机械器具及零件,8403,集中供暖用的热水锅炉，但品目8402的货品除外,3,1048434800,1493307668,2541742468
84 ,第84章  核反应堆、锅炉、机器、机械器具及零件,8404,品目8402或8403所列锅炉的辅助设备（例如，节热器、过热器、除灰器、气体回收器）；水蒸气或其他蒸汽动力装置的冷凝器,5,121399957,2288048849,2409448806
84 ,第84章  核反应堆、锅炉、机器、机械器具及零件,8405,煤气发生器，不论有无净化器；乙炔发生器及类似水解气体发生器，不论有无净化器,2,71306005,230194977,301500982
84 ,第84章  核反应堆、锅炉、机器、机械器具及零件,8406,汽轮机,6,1075810708,2035231970,3111042678
84 ,第84章  核反应堆、锅炉、机器、机械器具及零件,8407,点燃往复式或旋转式活塞内燃发动机,11,5290896046,15138124744,20429020790
84 ,第84章  核反应堆、锅炉、机器、机械器具及零件,8408,压燃式活塞内燃发动机（柴油或半柴油发动机）,7,15572663320,10635744054,26208407374
84 ,第84章  核反应堆、锅炉、机器、机械器具及零件,8409,专用于或主要用于品目8407或8408所列发动机的零件,8,15926808075,39901173127,55827981202
84 ,第84章  核反应堆、锅炉、机器、机械器具及零件,8410,水轮机、水轮及其调节器,8,10342403,857339178,867681581
84 ,第84章  核反应堆、锅炉、机器、机械器具及零件,8411,涡轮喷气发动机，涡轮螺桨发动机及其他燃气轮机,13,39120424389,15537139280,54657563669
84 ,第84章  核反应堆、锅炉、机器、机械器具及零件,8412,其他发动机及动力装置,10,8832933316,21939233394,30772166710
84 ,第84章  核反应堆、锅炉、机器、机械器具及零件,8413,液体泵，不论是否装有计量装置；液体提升机,30,25296823522,56593752061,81890575583
84 ,第84章  核反应堆、锅炉、机器、机械器具及零件,8414,空气泵或真空泵、空气及其他气体压缩机、风机、风扇；装有风扇的通风罩或循环气罩，不论是否装有过滤器；气密生物安全柜，不论是否装有过滤器,35,31161956816,1.26062E+11,1.57224E+11
84 ,第84章  核反应堆、锅炉、机器、机械器具及零件,8415,空气调节器，装有电扇及调温、调湿装置，包括不能单独调湿的空调器,11,3141239750,1.17701E+11,1.20842E+11
84 ,第84章  核反应堆、锅炉、机器、机械器具及零件,8416,使用液体燃料、粉状固体燃料或气体燃料的炉用燃料器；机械加煤机，包括其机械炉箅、机械除灰器及类似装置,6,711484676,822132369,1533617045
84 ,第84章  核反应堆、锅炉、机器、机械器具及零件,8417,非电热工业或实验室用炉及烘箱，包括焚烧炉,11,895178903,8261717325,9156896228
84 ,第84章  核反应堆、锅炉、机器、机械器具及零件,8418,电气或非电气的冷藏箱、冷冻箱及其他制冷设备；热泵，但品目8415的空气调节器除外,25,6726495343,77527251782,84253747125
84 ,第84章  核反应堆、锅炉、机器、机械器具及零件,8419,利用温度变化处理材料的机器、装置及类似的实验室设备，例如，加热、烹煮、烘炒、蒸馏、精馏、消毒、灭菌、汽蒸、干燥、蒸发、气化、冷凝、冷却的机器设备，不论是否电热除外；非电热的快速热水器或贮备式热水器,23,14169631006,35775768119,49945399125
84 ,第84章  核反应堆、锅炉、机器、机械器具及零件,8420,砑光机或其他滚压机器及其滚筒，但加工金属或玻璃的除外,3,3129888304,670040048,3799928352
84 ,第84章  核反应堆、锅炉、机器、机械器具及零件,8421,离心机，包括离心干燥剂；液体或气体的过滤、净化机器及装置,28,29781975196,59481306840,89263282036
84 ,第84章  核反应堆、锅炉、机器、机械器具及零件,8422,洗碟机；瓶子及其他容器的洗涤或干燥机器；瓶、罐、箱、袋或其他容器装填、封口、密封、贴标签的机器；瓶、罐、管、筒或类似容器的包封机器；其他包装或打包机器（包括热缩包装机器）；饮料充气机,12,9147301880,18375736971,27523038851
84 ,第84章  核反应堆、锅炉、机器、机械器具及零件,8423,衡器（感量≤50mg的天平除外），包括计数或检验用的衡器；衡器用的各种砝码砝码、秤砣,17,660884402,8990244292,9651128694
84 ,第84章  核反应堆、锅炉、机器、机械器具及零件,8424,液体或粉末的喷射、散布或喷雾的机械器具（不论是否手工操作）；灭火器，不论是否装药；喷枪及类似器具；喷汽机、喷砂机及类似的喷射机器,13,6677338699,26916239759,33593578458
84 ,第84章  核反应堆、锅炉、机器、机械器具及零件,8425,滑车及提升机，但倒卸式提升机除外；卷扬机及绞盘；千斤顶,11,1187195110,14654636105,15841831215
84 ,第84章  核反应堆、锅炉、机器、机械器具及零件,8426,船用桅杆式起重机；起重机，包括缆式起重机；移动式吊运架、跨运车及装有起重机的工作车,20,534323679,18684975906,19219299585
84 ,第84章  核反应堆、锅炉、机器、机械器具及零件,8427,叉车；其他装有升降或搬运装置的工作车,6,1104084388,29962949816,31067034204
84 ,第84章  核反应堆、锅炉、机器、机械器具及零件,8428,其他升降、搬运、装卸机械（例如，升降机、自动梯、输送机、缆车）,20,9405643042,30324003962,39729647004
84 ,第84章  核反应堆、锅炉、机器、机械器具及零件,8429,机动推土机、侧铲推土机、筑路机、平地机、铲运机、机械铲、挖掘机、机铲装载机、捣固机械及压路机,17,1086582735,63783926828,64870509563
84 ,第84章  核反应堆、锅炉、机器、机械器具及零件,8430,泥土、矿物或矿石的运送、平整、铲运、挖掘、捣固、压实、开采或钻探机械；打桩机及拔桩机；扫雪机及吹雪机,23,1087263920,10949735137,12036999057
84 ,第84章  核反应堆、锅炉、机器、机械器具及零件,8431,专用于或主要用于品目8425至8430所列机械的零件,13,8925509004,70406014576,79331523580
84 ,第84章  核反应堆、锅炉、机器、机械器具及零件,8432,农业、园林及林业用整地或耕作机械；草坪及运动场地滚压机,20,316260352,5570928823,5887189175
84 ,第84章  核反应堆、锅炉、机器、机械器具及零件,8433,收割机、脱粒机，包括草料打包机；割草机；蛋类、水果或其他农产品的清洁、分选、分级机器，但品目8437的机器除外,15,3776887829,19443364557,23220252386
84 ,第84章  核反应堆、锅炉、机器、机械器具及零件,8434,挤奶机及乳品加工机器,3,218930858,274236015,493166873
84 ,第84章  核反应堆、锅炉、机器、机械器具及零件,8435,制酒、制果汁或制类似饮料用的压榨机、轧碎机及类似机器,2,5742616,258077423,263820039
84 ,第84章  核反应堆、锅炉、机器、机械器具及零件,8436,农业、园艺、林业、家禽饲养业或养蜂业用的其他机器，包括装有机械或热力装置的催芽设备；家禽孵卵器及育雏器,6,408867878,4233208828,4642076706
84 ,第84章  核反应堆、锅炉、机器、机械器具及零件,8437,种子、谷物或干豆的清洁、分选或分级机器；谷物磨粉业加工机器或谷物、干豆加工机器，但农业用机器除外,4,102709383,2652354269,2755063652
84 ,第84章  核反应堆、锅炉、机器、机械器具及零件,8438,本章其他品目未列名的食品、饮料工业用的生产或加工机器，但提取、加工动物油脂、植物固定油脂或微生物油脂的机器除外,8,1724583130,6869033431,8593616561
84 ,第84章  核反应堆、锅炉、机器、机械器具及零件,8439,纤维素纸浆、纸及纸板的制造或整理机器,5,1966744447,4741291855,6708036302
84 ,第84章  核反应堆、锅炉、机器、机械器具及零件,8440,书本装订机器，包括锁线订书机,4,223657821,201662125,425319946
84 ,第84章  核反应堆、锅炉、机器、机械器具及零件,8441,其他制造纸浆制品、纸制品或纸板制品的机器，包括各种切纸机,9,792677300,8590152516,9382829816
84 ,第84章  核反应堆、锅炉、机器、机械器具及零件,8442,制印刷版（片）、滚筒及其他印刷部件用的机器、器具及设备（品目84.56至84.65的机器除外）；印刷用版（片）、滚筒及其他印刷部件；制成供印刷用（例如，刨平、压纹或抛光）的板（片）、滚筒及石板,6,193526756,865692226,1059218982
84 ,第84章  核反应堆、锅炉、机器、机械器具及零件,8443,用品目8442的印刷用版（片）、滚筒及其他印刷部件进行印刷的机器；其他打印机、复印机及传真机，不论是否组合式；上述机器的零件及附件,43,30217365100,75687158366,1.05905E+11
84 ,第84章  核反应堆、锅炉、机器、机械器具及零件,8444,化学纺织纤维挤压、拉伸、变形或切割机器,6,4315283382,1485759633,5801043015
84 ,第84章  核反应堆、锅炉、机器、机械器具及零件,8445,纺织纤维的预处理机器；纺纱机、并线机、加捻机及其他生产纺织纱线的机器；摇纱机、络纱机（包括卷纬机）及品目8446或8447机器用的纺织纱线预处理机器,27,3436649054,5053173659,8489822713
84 ,第84章  核反应堆、锅炉、机器、机械器具及零件,8446,织机,9,1561450965,2745127775,4306578740
84 ,第84章  核反应堆、锅炉、机器、机械器具及零件,8447,针织机、缝编机及制粗松螺旋花线、网眼薄纱、花边、刺绣品、装饰带、编织带或网的机器及簇绒机,11,567742007,6734123524,7301865531
84 ,第84章  核反应堆、锅炉、机器、机械器具及零件,8448,品目8444、8445、8446或8447所列机器的辅助机器（例如，多臂机、提花机、自停装置及换梭装置）；专用于或主要用于品目8444、8445、8446或8447所列机器的零件、附件（例如，锭子、锭壳、钢丝针布、梳、喷丝头、梭子、综丝、综框、针织机用针）,21,4113128601,5232797611,9345926212
84 ,第84章  核反应堆、锅炉、机器、机械器具及零件,8449,成匹、成形的毡呢或无纺织物制造或整理机器，包括制毡呢帽机器；帽模,3,926007430,1580873390,2506880820
84 ,第84章  核反应堆、锅炉、机器、机械器具及零件,8450,家用型或洗衣房用洗衣机，包括洗涤干燥两用机,11,511054496,24512852272,25023906768
84 ,第84章  核反应堆、锅炉、机器、机械器具及零件,8451,纱线、织物及纺织制品的洗涤、清洁、绞拧、干燥、熨烫、挤压（包括熔压）、漂白、染色、上浆、整理、涂布或浸渍机器（品目8450的机器除外）；列诺伦（亚麻油地毡）及类似铺地制品的布基或其他底布地浆料涂布机器；纺织物的卷绕、退绕、折叠、剪切或剪齿边机器,8,2679839802,8091185671,10771025473
84 ,第84章  核反应堆、锅炉、机器、机械器具及零件,8452,缝纫机，但品目8440的锁线订书机除外；缝纫机专用的特制家具、底座及罩盖；缝纫机针,14,912726063,12762570373,13675296436
84 ,第84章  核反应堆、锅炉、机器、机械器具及零件,8453,生皮、皮革的处理、鞣制或加工机器；鞋靴、毛皮及其他皮革制品的制作或修理机器，但缝纫机除外,4,160100198,2863450008,3023550206
84 ,第84章  核反应堆、锅炉、机器、机械器具及零件,8454,金属冶炼及铸造用的转炉、浇包、锭模及铸造机,13,1137070118,3773720878,4910790996
84 ,第84章  核反应堆、锅炉、机器、机械器具及零件,8455,金属轧机及其轧辊,12,1096679399,6973814637,8070494036
84 ,第84章  核反应堆、锅炉、机器、机械器具及零件,8456,用激光、其他光、光子束、超声波、放电、电化学法、电子束、离子束或等离子弧处理各种材料的加工机床；水射流切割机,9,5242097954,9491685342,14733783296
84 ,第84章  核反应堆、锅炉、机器、机械器具及零件,8457,加工金属的加工中心、单工位组合机床及多工位组合机床,7,12530295151,2185393053,14715688204
84 ,第84章  核反应堆、锅炉、机器、机械器具及零件,8458,切削金属的车床（包括车削中心）,5,2477189776,3359774907,5836964683
84 ,第84章  核反应堆、锅炉、机器、机械器具及零件,8459,切削金属的钻床、镗床、铣床、攻丝机床（包括直线移动式动力头机床），但品目8458的车床（包括车削中心）除外,14,934555363,2159032185,3093587548
84 ,第84章  核反应堆、锅炉、机器、机械器具及零件,8460,用磨石、磨料或抛光材料对金属或金属陶瓷进行去毛刺、刃磨、磨削、珩磨、研磨、抛光或其他精加工的机床，但品目8461的切齿机、齿轮磨床或齿轮精加工机床除外,24,4157461923,1824573091,5982035014
84 ,第84章  核反应堆、锅炉、机器、机械器具及零件,8461,切削金属或金属陶瓷的刨床、牛头刨床、插床、拉床、切齿机、齿轮磨床或齿轮精加工机床、锯末、切断机及未列名的切削机床,10,2577600681,1993281162,4570881843
84 ,第84章  核反应堆、锅炉、机器、机械器具及零件,8462,加工金属的锻造、锻锤或模锻（但轧机除外）机床（包括压力机）；加工金属的弯曲、折叠、矫直、矫平、剪切、冲孔、开槽或步冲机床（包括压力机、纵剪线及定尺剪切线，但拉拔机除外）；其他加工金属或硬质合金的压力机,32,4164726754,6872472274,11037199028
84 ,第84章  核反应堆、锅炉、机器、机械器具及零件,8463,金属或金属陶瓷的其他非切削加工机床,7,878008758,2150661740,3028670498
84 ,第84章  核反应堆、锅炉、机器、机械器具及零件,8464,石料、陶瓷、混凝土、石棉水泥或类似矿物材料的加工机床、玻璃冷加工机床,9,1929808106,3350635203,5280443309
84 ,第84章  核反应堆、锅炉、机器、机械器具及零件,8465,木材、软木、骨、硬质橡胶、硬质塑料或类似硬质材料的加工机床（包括用打钉或打U形钉、胶粘或其他方法组合前述材料的机器）,10,1009255945,12965043450,13974299395
84 ,第84章  核反应堆、锅炉、机器、机械器具及零件,8466,专用于或主要用于品目84.56至84.65所列机器的零件、附件，包括工件或工具的夹具、自启板牙切头、分度头及其他专用于机器的附件；各种手提工具的工具夹具,8,8440044481,9383236472,17823280953
84 ,第84章  核反应堆、锅炉、机器、机械器具及零件,8467,手提式风动或液压工具及本身有电动或非电动动力装置的手提式工具,15,3184724958,71462524451,74647249409
84 ,第84章  核反应堆、锅炉、机器、机械器具及零件,8468,焊接机器及装置，不论是否兼有切割功能，但品目8515的货品除外；气体加温表面回火机器及装置,4,320056262,1678596600,1998652862
84 ,第84章  核反应堆、锅炉、机器、机械器具及零件,8470,计算机器及具有计算功能的袖珍式数据记录、重现及显示机器；装有计算装置的会计计算机、邮资盖戳机、售票机及类似机器；现金出纳机,7,336363987,14248587342,14584951329
84 ,第84章  核反应堆、锅炉、机器、机械器具及零件,8471,自动数据处理设备及其部件；其他品目未列名的磁性或光学阅读机、将数据以代码形式转录到数据记录媒体的机器及处理这些数据的机器,28,1.78221E+11,9.37751E+11,1.11597E+12
84 ,第84章  核反应堆、锅炉、机器、机械器具及零件,8472,其他办公室用机器（例如，胶版复印机、油印机、地址机写机、自动付钞机、硬币分类、计数及包装机、削铅笔机、打洞机或订书机）,12,68527707,6488603660,6557131367
84 ,第84章  核反应堆、锅炉、机器、机械器具及零件,8473,专用于或主要用于品目84.70至84.72所列机器的零件、附件（罩套、提箱及类似品除外）,8,1.16929E+11,1.73494E+11,2.90423E+11
84 ,第84章  核反应堆、锅炉、机器、机械器具及零件,8474,泥土、石料、矿石或其他固体（包括粉状、浆状）矿物质的分类、筛选、分离、洗涤、破碎、磨粉、混合或搅拌机器；固体矿物燃料、陶瓷胚泥、未硬化水泥、石膏材料或其他粉状，浆状矿产品的粘聚或成型机器；铸造用砂模的成型机器,11,2290777551,23707067242,25997844793
84 ,第84章  核反应堆、锅炉、机器、机械器具及零件,8475,白炽灯泡、灯管、放电灯管、电子管、闪光灯泡及类似品的封装机器；玻璃或玻璃制品的制造或热加工机器,7,1386651674,1865908522,3252560196
84 ,第84章  核反应堆、锅炉、机器、机械器具及零件,8476,自动售货机（例如，出售邮票、香烟、食品或饮料的机器），包括钱币兑换机,5,61843813,1727394645,1789238458
84 ,第84章  核反应堆、锅炉、机器、机械器具及零件,8477,本章其他品目未列名的橡胶或塑料及其产品的加工机器,14,15735755534,31570355386,47306110920
84 ,第84章  核反应堆、锅炉、机器、机械器具及零件,8478,本章其他品目未列名的烟草加工及制作机器,2,456895745,99079633,555975378
84 ,第84章  核反应堆、锅炉、机器、机械器具及零件,8479,本章其他品目未列名的具有独立功能的机器及机械器具,29,65773587702,60406584541,1.2618E+11
84 ,第84章  核反应堆、锅炉、机器、机械器具及零件,8480,金属铸造用型箱；型模底板；阳模；金属用型模（锭模除外）、硬质合金、玻璃、矿物材料、橡胶或塑料用型模,12,3660854046,29522842113,33183696159
84 ,第84章  核反应堆、锅炉、机器、机械器具及零件,8481,用于管道、锅炉、罐、桶或类似品的龙头、旋塞、阀门及类似装置，包括减压阀及恒温控制阀,13,48149108579,1.11118E+11,1.59267E+11
84 ,第84章  核反应堆、锅炉、机器、机械器具及零件,8482,滚动轴承,12,22935027999,34930129786,57865157785
84 ,第84章  核反应堆、锅炉、机器、机械器具及零件,8483,传动轴（包括凸轮轴及曲柄轴）及曲柄；轴承座及滑动轴承；齿轮及齿轮传动装置；滚珠或滚子螺杆传动装置；齿轮箱及其他变速装置，包括扭矩变换器；飞轮及滑轮，包括滑轮组；离合器及连轴器（包括万向节）,11,29232748569,53307603758,82540352327
84 ,第84章  核反应堆、锅炉、机器、机械器具及零件,8484,密封垫或类似接合衬垫，用金属片与其他材料制成或用双层或多层金属片制成；成套或各种不用材料的密封垫或类似接合衬垫，装于袋、套或类似包装内；机械密封件,3,3413938025,3096233626,6510171651
84 ,第84章  核反应堆、锅炉、机器、机械器具及零件,8485,增材制造设备,14,335311045,2824150681,3159461726
84 ,第84章  核反应堆、锅炉、机器、机械器具及零件,8486,专用于或主要用于制造半导体单晶柱或晶圆、半导体器件、集成电路或平板显示器的机器及装置；本章注释11（3）规定的机器及装置；零件及附件,34,1.83359E+11,20199111395,2.03558E+11
84 ,第84章  核反应堆、锅炉、机器、机械器具及零件,8487,本章其他品目未列名的机器零件，不具有电气接插件、绝缘体、线圈、触点或其他电气器材特征的,2,3175396063,9490348562,12665744625
85 ,第85章  电机、电气设备及其零件；录音机及放声机、电视图像、声音的录制和重放设备及其零件、附件,8501,电动机及发电机（不包括发电机组）,29,21929876336,80386359149,1.02316E+11
85 ,第85章  电机、电气设备及其零件；录音机及放声机、电视图像、声音的录制和重放设备及其零件、附件,8502,发电机组及旋转式变流机,8,3752392359,30622067664,34374460023
85 ,第85章  电机、电气设备及其零件；录音机及放声机、电视图像、声音的录制和重放设备及其零件、附件,8503,专用于或主要用于品目8501或8502所列机器的零件,4,5270340804,38648930516,43919271320
85 ,第85章  电机、电气设备及其零件；录音机及放声机、电视图像、声音的录制和重放设备及其零件、附件,8504,变压器、静止式变流器（例如整流器）及电感器,30,60430524548,2.25567E+11,2.85997E+11
85 ,第85章  电机、电气设备及其零件；录音机及放声机、电视图像、声音的录制和重放设备及其零件、附件,8505,电磁铁；永磁铁及磁化后准备制永磁铁的物品；电磁铁或永磁铁卡盘、夹具及类似的工具夹具；电磁联轴节、离合器及制动器；电磁起重吸盘,6,4523034712,30086958180,34609992892
85 ,第85章  电机、电气设备及其零件；录音机及放声机、电视图像、声音的录制和重放设备及其零件、附件,8506,原电池及原电池组,11,1881995259,13023741885,14905737144
85 ,第85章  电机、电气设备及其零件；录音机及放声机、电视图像、声音的录制和重放设备及其零件、附件,8507,蓄电池，包括隔板，不论是否矩形（包括正方形）,9,19790403591,2.61119E+11,2.8091E+11
85 ,第85章  电机、电气设备及其零件；录音机及放声机、电视图像、声音的录制和重放设备及其零件、附件,8508,真空吸尘器,5,1848628918,32440372632,34289001550
85 ,第85章  电机、电气设备及其零件；录音机及放声机、电视图像、声音的录制和重放设备及其零件、附件,8509,家用电动器具，品目8508的真空吸尘器除外,6,1249276971,54421404370,55670681341
85 ,第85章  电机、电气设备及其零件；录音机及放声机、电视图像、声音的录制和重放设备及其零件、附件,8510,电动剃须刀、电动毛发推剪及电动脱毛器,4,1003816090,9373366212,10377182302
85 ,第85章  电机、电气设备及其零件；录音机及放声机、电视图像、声音的录制和重放设备及其零件、附件,8511,点燃式或压燃式内燃发动机用的电点火及电启动装置（例如，点火磁电机、永磁直流发电机、点火线圈、火花塞、电热塞及启动电机）；附属于上述内燃发动机的发电机（例如，直流发电机、交流发电机）及断流器,13,5221188709,14952927372,20174116081
85 ,第85章  电机、电气设备及其零件；录音机及放声机、电视图像、声音的录制和重放设备及其零件、附件,8512,自行车或机动车辆用的电气照明或信号装置（品目8539的物品除外）、电动风挡刮水器、除霜器及去雾器,9,13056224428,29001145670,42057370098
85 ,第85章  电机、电气设备及其零件；录音机及放声机、电视图像、声音的录制和重放设备及其零件、附件,8513,"自供能源(例如,使用干电池、蓄电池、永磁发电机)的手提式电灯，但品目85.12的照明装置除外",4,47011178,14806482666,14853493844
85 ,第85章  电机、电气设备及其零件；录音机及放声机、电视图像、声音的录制和重放设备及其零件、附件,8514,工业或实验室用电炉及电烘箱（包括通过感应或介质损耗工作的）；工业或实验室用其他通过感应或介质损耗对材料进行热处理的设备,10,5182947945,5840338190,11023286135
85 ,第85章  电机、电气设备及其零件；录音机及放声机、电视图像、声音的录制和重放设备及其零件、附件,8515,电气（包括电热气体）、激光、其他光、光子束、超声波、电子束、磁脉冲或等离子弧焊接机器及装置，不论是否兼有切割功能；用于热喷金属或金属陶瓷的电气机器及装置,13,4177127139,12370816341,16547943480
85 ,第85章  电机、电气设备及其零件；录音机及放声机、电视图像、声音的录制和重放设备及其零件、附件,8516,电热的快速热水器、储存式热水器、浸入式液体加热器；电气空间加热器及土壤加热器；电热的理发器具（例如，电吹风机、电卷发机、电热发钳）及干手器；电熨斗；其他家用电热器具；加热电阻器，但品目8545的货品除外,32,8467820359,1.46974E+11,1.55442E+11
85 ,第85章  电机、电气设备及其零件；录音机及放声机、电视图像、声音的录制和重放设备及其零件、附件,8517,电话机，包括用于蜂窝网络或其他无线网络的智能手机及其他电话机；其他发送或接收声音、图像或其他数据用的设备，包括有线或无线网络（例如，局域网或广域网）的通信设备，品目8443、8525、8527或8528的发送或接收设备除外,35,1.1474E+11,1.1278E+12,1.24254E+12
85 ,第85章  电机、电气设备及其零件；录音机及放声机、电视图像、声音的录制和重放设备及其零件、附件,8518,传声器（麦克风）及其座架；扬声器，不论是否装成音箱；耳机、耳塞，不论是否装有传声器，用传声器及一个或多个扬声器组成的组合机；音频扩大器；电器扩音机组,8,17381282266,1.01963E+11,1.19344E+11
85 ,第85章  电机、电气设备及其零件；录音机及放声机、电视图像、声音的录制和重放设备及其零件、附件,8519,声音录制或重放设备,11,221404012,7925007473,8146411485
85 ,第85章  电机、电气设备及其零件；录音机及放声机、电视图像、声音的录制和重放设备及其零件、附件,8521,视频信号录制或重放设备，不论是否装有高频调节器,7,187295200,11478866959,11666162159
85 ,第85章  电机、电气设备及其零件；录音机及放声机、电视图像、声音的录制和重放设备及其零件、附件,8522,专用于或主要用于品目8519或8521所列设备的零件、附件,10,537908580,2778031816,3315940396
85 ,第85章  电机、电气设备及其零件；录音机及放声机、电视图像、声音的录制和重放设备及其零件、附件,8523,录制声音或其他信息用的圆盘、磁带、固态非易失性数据存储器件、“智能卡”及其他媒体，不论是否已录制，包括供复制圆盘用的母片及母带，但不包括第37章的产品,26,25315812916,24074399742,49390212658
85 ,第85章  电机、电气设备及其零件；录音机及放声机、电视图像、声音的录制和重放设备及其零件、附件,8524,平板显示模组，不论是否装有触摸屏,22,1.88686E+11,1.89088E+11,3.77773E+11
85 ,第85章  电机、电气设备及其零件；录音机及放声机、电视图像、声音的录制和重放设备及其零件、附件,8525,无线电广播、电视发送设备，不论是否装有接收装置或声音的录制、重放装置；电视摄像机、数字照相机及视频摄录一体机,23,11796083843,51706249661,63502333504
85 ,第85章  电机、电气设备及其零件；录音机及放声机、电视图像、声音的录制和重放设备及其零件、附件,8526,雷达设备、无线电导航设备及无线电遥控设备,5,7154751183,13910928334,21065679517
85 ,第85章  电机、电气设备及其零件；录音机及放声机、电视图像、声音的录制和重放设备及其零件、附件,8527,无线电广播接收设备，不论是否与声音的录制、重放装置或时钟组合在同一机壳内,8,430288486,18472826929,18903115415
85 ,第85章  电机、电气设备及其零件；录音机及放声机、电视图像、声音的录制和重放设备及其零件、附件,8528,监视器及投影机，未装电视接收装置；电视接收装置，不论是否装有无线电收音装置或声音、图像的录制或重放装置,32,2821504218,1.89971E+11,1.92792E+11
85 ,第85章  电机、电气设备及其零件；录音机及放声机、电视图像、声音的录制和重放设备及其零件、附件,8529,专用于或主要用于品目8524至8528所列装置或设备的零件,13,82925569347,78307095933,1.61233E+11
85 ,第85章  电机、电气设备及其零件；录音机及放声机、电视图像、声音的录制和重放设备及其零件、附件,8530,铁道、电车道、道路或内河航道、停车场、港口或机场用的电气信号、安全或交通管理设备（品目8608的货品除外）,3,147399342,1871913628,2019312970
85 ,第85章  电机、电气设备及其零件；录音机及放声机、电视图像、声音的录制和重放设备及其零件、附件,8531,电气音响或视觉信号装置（例如，电铃、电笛、显示板、防盗或防火报警器），但品目8512或8530的货品除外,6,2907170750,27283664695,30190835445
85 ,第85章  电机、电气设备及其零件；录音机及放声机、电视图像、声音的录制和重放设备及其零件、附件,8532,固定、可变或可调（微调）电容器,14,52938924952,37498046156,90436971108
85 ,第85章  电机、电气设备及其零件；录音机及放声机、电视图像、声音的录制和重放设备及其零件、附件,8533,电阻器（包括变阻器及电位器），但加热电阻器除外,8,21243914808,27633446783,48877361591
85 ,第85章  电机、电气设备及其零件；录音机及放声机、电视图像、声音的录制和重放设备及其零件、附件,8534,印刷电路,2,54197169412,99711637560,1.53909E+11
85 ,第85章  电机、电气设备及其零件；录音机及放声机、电视图像、声音的录制和重放设备及其零件、附件,8535,电路开关、保护或连接用的电气装置（例如，开关、熔断器、避雷器、电压限幅器、电涌抑制器、插头及其他连接器、接线盒），用于电压＞1000V的线路,10,1261399675,5220272142,6481671817
85 ,第85章  电机、电气设备及其零件；录音机及放声机、电视图像、声音的录制和重放设备及其零件、附件,8536,电路开关、保护或连接用的电气装置（例如，开关、继电器、熔断器、电涌抑制器、插头、插座、灯座及其他连接器、接线盒），用于电压≤1000V的线路；光导纤维、光导纤维束或光缆用连接器,13,76281824760,1.15539E+11,1.91821E+11
85 ,第85章  电机、电气设备及其零件；录音机及放声机、电视图像、声音的录制和重放设备及其零件、附件,8537,用于电气控制或电力分配的盘、板、台、柜及其他基座，装有两个或多个品目8535或8536所列的装置，包括装有第90章所列仪器或装置，以及数控装置，但品目8517的交换机除外,5,31631108469,60181706024,91812814493
85 ,第85章  电机、电气设备及其零件；录音机及放声机、电视图像、声音的录制和重放设备及其零件、附件,8538,专用于或主要用于品目8535、8536或8537所列装置的零件,3,21496941316,27752961221,49249902537
85 ,第85章  电机、电气设备及其零件；录音机及放声机、电视图像、声音的录制和重放设备及其零件、附件,8539,白炽灯泡、放电灯管，包括封闭式聚光灯及紫外线灯管或红外线灯泡；弧光灯；发光二极管（LED）光源,29,2721689498,45196064948,47917754446
85 ,第85章  电机、电气设备及其零件；录音机及放声机、电视图像、声音的录制和重放设备及其零件、附件,8540,热电子管、冷阴极管或光阴极管（例如，真空管或充气管、汞弧整流管、阴极射线管、电视摄像管）,18,788309751,534543945,1322853696
85 ,第85章  电机、电气设备及其零件；录音机及放声机、电视图像、声音的录制和重放设备及其零件、附件,8541,半导体器件（例如，二极管、晶体管，半导体基换能器）；光敏半导体器件，包括不论是否装在组件内或组装成块的光电池；发光二极管（LED），不论是否与其他发光二极管（LED）组装；已装配的压电晶体,19,1.60042E+11,3.34125E+11,4.94167E+11
85 ,第85章  电机、电气设备及其零件；录音机及放声机、电视图像、声音的录制和重放设备及其零件、附件,8542,集成电路,10,2.07697E+12,7.62768E+11,2.83974E+12
85 ,第85章  电机、电气设备及其零件；录音机及放声机、电视图像、声音的录制和重放设备及其零件、附件,8543,本章其他品目未列名的具有独立功能的电气设备及装置,15,32347688225,1.03883E+11,1.3623E+11
85 ,第85章  电机、电气设备及其零件；录音机及放声机、电视图像、声音的录制和重放设备及其零件、附件,8544,绝缘(包括漆包或阳极化处理)电线、电缆(包括同轴电缆)及其他绝缘电导体，不论是否有接头;由多根具有独立保护套的光纤组成的光缆，不论是否与电导体装配或装有接头,19,30757435722,1.55208E+11,1.85965E+11
85 ,第85章  电机、电气设备及其零件；录音机及放声机、电视图像、声音的录制和重放设备及其零件、附件,8545,碳电极、碳刷、灯碳棒、电池碳棒及电气设备用的其他石墨或碳精制品，不论是否带金属,4,834992164,18656902478,19491894642
85 ,第85章  电机、电气设备及其零件；录音机及放声机、电视图像、声音的录制和重放设备及其零件、附件,8546,各种材料制的绝缘子,4,839515410,2993658464,3833173874
85 ,第85章  电机、电气设备及其零件；录音机及放声机、电视图像、声音的录制和重放设备及其零件、附件,8547,电气机器、器具或设备用的绝缘配件，除了为装配需要而在模制时装入的小金属零件（例如螺纹孔）以外，全部用绝缘材料制成，但品目8546的绝缘子除外；内衬绝缘材料的贱金属制线路导管及其接头,4,3662707129,4185732623,7848439752
85 ,第85章  电机、电气设备及其零件；录音机及放声机、电视图像、声音的录制和重放设备及其零件、附件,8548,机器或设备的本章其他品目未列名的电气零件,1,9465300269,8104317224,17569617493
85 ,第85章  电机、电气设备及其零件；录音机及放声机、电视图像、声音的录制和重放设备及其零件、附件,8549,电子电气废弃物及碎料,11,0,16550471,16550471
86 ,第86章  铁道及电车道机车、车辆及其零件；铁道及电车道轨道固定装置及其零件；附件；各种机械（包括电动机械）交通信号设备,8601,铁道电力机车，由外部电力或蓄电池驱动,5,2341032,954178573,956519605
86 ,第86章  铁道及电车道机车、车辆及其零件；铁道及电车道轨道固定装置及其零件；附件；各种机械（包括电动机械）交通信号设备,8602,其他铁道机车；机车煤水车,3,160427248,1066151403,1226578651
86 ,第86章  铁道及电车道机车、车辆及其零件；铁道及电车道轨道固定装置及其零件；附件；各种机械（包括电动机械）交通信号设备,8603,铁道及电车道机动客车、货车、敞车，但品目8604的货品除外,2,0,4674607461,4674607461
86 ,第86章  铁道及电车道机车、车辆及其零件；铁道及电车道轨道固定装置及其零件；附件；各种机械（包括电动机械）交通信号设备,8604,铁道及电车维修或服务车，不论是否机动（例如，工场车、起重机车、道砟捣固车、轨道校正车、检验车及查道车）,5,62194564,832863566,895058130
86 ,第86章  铁道及电车道机车、车辆及其零件；铁道及电车道轨道固定装置及其零件；附件；各种机械（包括电动机械）交通信号设备,8605,铁道及电车道非机动客车；行李车、邮政车和其他铁道及电车道非机动特殊用途车辆（品目8604的货品除外）,2,0,128432194,128432194
86 ,第86章  铁道及电车道机车、车辆及其零件；铁道及电车道轨道固定装置及其零件；附件；各种机械（包括电动机械）交通信号设备,8606,铁道及电车道非机动有篷及无篷货车,5,959451,1911302725,1912262176
86 ,第86章  铁道及电车道机车、车辆及其零件；铁道及电车道轨道固定装置及其零件；附件；各种机械（包括电动机械）交通信号设备,8607,铁道及电车道机车或车辆的零件,9,1927591369,6453646869,8381238238
86 ,第86章  铁道及电车道机车、车辆及其零件；铁道及电车道轨道固定装置及其零件；附件；各种机械（包括电动机械）交通信号设备,8608,铁道及电车道轨道固定装置及附件；供铁路、电车道、道路、内河航道、停车场、港口或机场用的机械（包括电动机械）信号、安全或交通管理设备；上述货品的零件,2,105824897,673961970,779786867
86 ,第86章  铁道及电车道机车、车辆及其零件；铁道及电车道轨道固定装置及其零件；附件；各种机械（包括电动机械）交通信号设备,8609,集装箱（包括运输液体的集装箱），经特殊设计、装备是用于各种运输方式,8,399732248,82795284813,83195017061
87 ,第87章  车辆及其零件、附件，但铁道及电车道车辆除外,8701,牵引车、拖拉机（品目8709的牵引车除外）,17,710137464,16451775810,17161913274
87 ,第87章  车辆及其零件、附件，但铁道及电车道车辆除外,8702,客运机动车辆，≥10座（包括驾驶座）,17,182618976,11340764913,11523383889
87 ,第87章  车辆及其零件、附件，但铁道及电车道车辆除外,8703,主要用于载人的机动车辆（品目8702的货品除外），包括旅行小客车及赛车,169,2.65355E+11,1.89461E+11,4.54816E+11
87 ,第87章  车辆及其零件、附件，但铁道及电车道车辆除外,8704,货运机动车辆,18,3318233940,46402334667,49720568607
87 ,第87章  车辆及其零件、附件，但铁道及电车道车辆除外,8705,特殊用途的机动车辆（例如，抢修车、起重车、救火车、混凝土搅拌车、道路清洁车、喷洒车、流动工场车及流动放射线检查车），但主要用于载人或运货的车辆除外,21,476477822,9552736674,10029214496
87 ,第87章  车辆及其零件、附件，但铁道及电车道车辆除外,8706,装有发动机的机动车辆底盘，品目8701至8705所列车辆用,6,133047060,1921310029,2054357089
87 ,第87章  车辆及其零件、附件，但铁道及电车道车辆除外,8707,机动车辆的车身（包括驾驶室），品目8701至8705所列车辆用,3,127293713,3842306168,3969599881
87 ,第87章  车辆及其零件、附件，但铁道及电车道车辆除外,8708,机动车的零件、附件，品目8701至8705所列车辆用,89,1.27221E+11,2.4441E+11,3.71631E+11
87 ,第87章  车辆及其零件、附件，但铁道及电车道车辆除外,8709,短距离运输货物的机动车辆，为装有提升或搬运设备，用于工厂、仓库、码头或机场；火车站台上用的牵引车；上述车辆的零件,5,59141956,766041586,825183542
87 ,第87章  车辆及其零件、附件，但铁道及电车道车辆除外,8710,坦克及其他机动装甲战斗车辆，不论是否装有武器；上述车辆的零件,2,0,0,0
87 ,第87章  车辆及其零件、附件，但铁道及电车道车辆除外,8711,摩托车（包括机器脚踏两用车）及装有辅助动力装置的脚踏车，不论有无边车；边车,12,5345274003,61505209984,66850483987
87 ,第87章  车辆及其零件、附件，但铁道及电车道车辆除外,8712,自行车等非机动脚踏车（包括运货三轮车）,7,366550254,19706355724,20072905978
87 ,第87章  车辆及其零件、附件，但铁道及电车道车辆除外,8713,残疾人用车，不论是否机动或其他机械驱动,2,11866596,5231664853,5243531449
87 ,第87章  车辆及其零件、附件，但铁道及电车道车辆除外,8714,零件、附件，品目8711至8713所列车辆用,13,4506131482,57775360280,62281491762
87 ,第87章  车辆及其零件、附件，但铁道及电车道车辆除外,8715,婴孩车及其零件,1,39572286,8541885987,8581458273
87 ,第87章  车辆及其零件、附件，但铁道及电车道车辆除外,8716,挂车及半挂车或其他非机械驱动车辆及其零件,9,448576806,30091370752,30539947558
88 ,第88章  航空器、航天器及其零件,8801,气球及飞艇；滑翔机、悬挂滑翔机及其他无动力航空器,2,768410,5786488,6554898
88 ,第88章  航空器、航天器及其零件,8802,其他航空器(例如，直升机、飞机)，品目88.06的无人驾驶航空器除外；航天器(包括卫星)及运载工具，亚轨道运载工具,8,30392036473,7577652611,37969689084
88 ,第88章  航空器、航天器及其零件,8804,降落伞（包括可操纵降落伞及滑翔降落伞）、旋翼降落伞及其零件、附件,1,11952351,32117634,44069985
88 ,第88章  航空器、航天器及其零件,8805,航空器的发射装置、甲板停机装置或类似装置和地面飞行训练器及其零件,3,568764562,32713559,601478121
88 ,第88章  航空器、航天器及其零件,8806,无人驾驶航空器,20,410139959,8587921780,8998061739
88 ,第88章  航空器、航天器及其零件,8807,品目88.01、88.02或88.06所列货品的零件,4,11645240259,8901259455,20546499714
89 ,第89章  船舶及浮动结构体,8901,巡航船、游览船、渡船、货船、驳船及其类似的客运或货运船舶,24,2684543823,92686764237,95371308060
89 ,第89章  船舶及浮动结构体,8902,捕鱼船；加工船及其他加工保藏鱼类产品的船舶,2,0,186343379,186343379
89 ,第89章  船舶及浮动结构体,8903,娱乐或运动用快艇及其他船舶；划艇及轻舟,11,519862636,3292924182,3812786818
89 ,第89章  船舶及浮动结构体,8904,拖轮及顶推船,1,441844366,1846371910,2288216276
89 ,第89章  船舶及浮动结构体,8905,灯船、消防船、挖泥船、起重船及其他不以航行为主要功能的船舶；浮船坞；浮动或潜水时钻探或生产平台,4,2954584500,27306127496,30260711996
89 ,第89章  船舶及浮动结构体,8906,其他船舶，包括军舰及救生船，但划艇除外,4,69855051,953813213,1023668264
89 ,第89章  船舶及浮动结构体,8907,其他浮动结构体（例如，筏、柜、潜水箱、浮码头、浮筒及航标）,2,70382593,1179376383,1249758976
89 ,第89章  船舶及浮动结构体,8908,供拆卸的船舶及其他浮动结构体,1,0,0,0
90 ,第90章  光学、照相、电影、计量、检验、医疗或外科用仪器及设备、精密仪器及设备；上述物品的零件、附件,9001,光导纤维及光导纤维束；光缆，但品目8544的货品除外；偏振材料制的片及板；未装配的各种材料制透镜（包括隐形眼镜片）、棱镜、反射镜及其他光学元件，但未经光学加工的玻璃制上述元件除外,11,40590963129,28749513368,69340476497
90 ,第90章  光学、照相、电影、计量、检验、医疗或外科用仪器及设备、精密仪器及设备；上述物品的零件、附件,9002,已装配的各种材料制透镜、棱镜、反射镜及其他光学元件，作为仪器或装置的零件、附件，但未经光学加工的玻璃制上述元件除外,11,20954149076,19624625384,40578774460
90 ,第90章  光学、照相、电影、计量、检验、医疗或外科用仪器及设备、精密仪器及设备；上述物品的零件、附件,9003,眼镜架及其零件,5,1196030566,10279204781,11475235347
90 ,第90章  光学、照相、电影、计量、检验、医疗或外科用仪器及设备、精密仪器及设备；上述物品的零件、附件,9004,矫正视力、保护眼睛或其他用途的眼镜、挡风镜及类似品,3,1929399649,19013237489,20942637138
90 ,第90章  光学、照相、电影、计量、检验、医疗或外科用仪器及设备、精密仪器及设备；上述物品的零件、附件,9005,双筒望远镜、单筒望远镜、其他光学望远镜及其座架；其他天文仪器及其座架，但不包括射电天文仪器,5,92594148,3163474206,3256068354
90 ,第90章  光学、照相、电影、计量、检验、医疗或外科用仪器及设备、精密仪器及设备；上述物品的零件、附件,9006,照相机（电影摄影机除外）；照相闪光灯装置及闪光灯泡，但品目8539的放电灯泡除外,20,2981967337,3426375173,6408342510
90 ,第90章  光学、照相、电影、计量、检验、医疗或外科用仪器及设备、精密仪器及设备；上述物品的零件、附件,9007,电影摄影机、放映机，不论是否带有声音的录制或重放装置,6,261158557,762992786,1024151343
90 ,第90章  光学、照相、电影、计量、检验、医疗或外科用仪器及设备、精密仪器及设备；上述物品的零件、附件,9008,影像投影仪，但电影用除外；照片（电影片除外）放大机及缩片机,8,24780417,418296247,443076664
90 ,第90章  光学、照相、电影、计量、检验、医疗或外科用仪器及设备、精密仪器及设备；上述物品的零件、附件,9010,本章其他品目未列名的照相（包括电影）洗印用装置及设备；负片显示器；银幕及其他投影屏幕,12,1329311449,868341891,2197653340
90 ,第90章  光学、照相、电影、计量、检验、医疗或外科用仪器及设备、精密仪器及设备；上述物品的零件、附件,9011,复式光学显微镜，包括用于显微照相、显微电影摄影及显微投影的,4,3434063235,1842532893,5276596128
90 ,第90章  光学、照相、电影、计量、检验、医疗或外科用仪器及设备、精密仪器及设备；上述物品的零件、附件,9012,显微镜，但光学显微镜除外；衍射设备,2,6851497605,293959283,7145456888
90 ,第90章  光学、照相、电影、计量、检验、医疗或外科用仪器及设备、精密仪器及设备；上述物品的零件、附件,9013,激光器、但激光二极管除外；本章其他品目未列名的光学仪器及器具,7,15058235027,8201588757,23259823784
90 ,第90章  光学、照相、电影、计量、检验、医疗或外科用仪器及设备、精密仪器及设备；上述物品的零件、附件,9014,定向罗盘；其他导航仪器及装置,6,1899479958,443536324,2343016282
90 ,第90章  光学、照相、电影、计量、检验、医疗或外科用仪器及设备、精密仪器及设备；上述物品的零件、附件,9015,大地测量（包括摄影测量）、水道测量、海洋、水文、气象或地球地理用仪器及装置，不包括罗盘；测距仪,6,4107381844,6434589987,10541971831
90 ,第90章  光学、照相、电影、计量、检验、医疗或外科用仪器及设备、精密仪器及设备；上述物品的零件、附件,9016,感量≤50毫克的天平，不论是否带有砝码,2,328717884,395221462,723939346
90 ,第90章  光学、照相、电影、计量、检验、医疗或外科用仪器及设备、精密仪器及设备；上述物品的零件、附件,9017,绘图、画线或数学计算仪器及器具（例如，绘图机、比例缩放仪、分度规、绘图工具、计算尺及盘式计算器）；本章其他品目未列名的手用测量长度的器具（例如，量尺、量带、千分尺及卡尺）,5,499339430,5302797786,5802137216
90 ,第90章  光学、照相、电影、计量、检验、医疗或外科用仪器及设备、精密仪器及设备；上述物品的零件、附件,9018,医疗、外科、牙科或兽医用仪器及器具，包括闪烁扫描装置、其他电气医疗装置及视力检查仪器,29,60340604054,50591638197,1.10932E+11
90 ,第90章  光学、照相、电影、计量、检验、医疗或外科用仪器及设备、精密仪器及设备；上述物品的零件、附件,9019,机械疗法器具；按摩器具；心理功能测验装置；臭氧治疗器；氧气治疗器、喷雾治疗器、人工呼吸器及其他治疗用呼吸器具,5,1736109717,32063853362,33799963079
90 ,第90章  光学、照相、电影、计量、检验、医疗或外科用仪器及设备、精密仪器及设备；上述物品的零件、附件,9020,其他呼吸器具及防毒面具，但不包括既无机械零件又无可互换过滤器的防护面具,1,462056315,373465170,835521485
90 ,第90章  光学、照相、电影、计量、检验、医疗或外科用仪器及设备、精密仪器及设备；上述物品的零件、附件,9021,矫形器具，包括支具、外科手术带、氙气带；甲板及其他骨拆用具；人造的人体部分；助听器及为弥补生理缺陷或残疾而穿戴、携带或植入人体内的其他器具,10,19391260936,11613434968,31004695904
90 ,第90章  光学、照相、电影、计量、检验、医疗或外科用仪器及设备、精密仪器及设备；上述物品的零件、附件,9022,X射线或α射线、β射线、γ射线或其他离子射线的应用设备，不论是否用于医疗、外科、牙科或兽医，包括射线照相及射线治疗设备，X射线管及其他X射线发生器、高压发生器、控制板及控制台、荧光屏、检查或治疗用的桌、椅及类似品,13,20691328382,12602043331,33293371713
90 ,第90章  光学、照相、电影、计量、检验、医疗或外科用仪器及设备、精密仪器及设备；上述物品的零件、附件,9023,专供示范（例如，教学或展览）而无其他用途的仪器、装置及模型,2,753241251,3737405456,4490646707
90 ,第90章  光学、照相、电影、计量、检验、医疗或外科用仪器及设备、精密仪器及设备；上述物品的零件、附件,9024,各种材料（例如，金属、木材、纺织材料、纸张、塑料）的硬度、强度、压缩性、弹性或其他机械性能的试验机器及器具,5,1815527659,716623488,2532151147
90 ,第90章  光学、照相、电影、计量、检验、医疗或外科用仪器及设备、精密仪器及设备；上述物品的零件、附件,9025,记录式或非纪录式的液体比重计及类似的浮子式仪器、温度计、高温计、气压计、湿度计、干湿球温度计及其组合装置,5,4835783847,7385427232,12221211079
90 ,第90章  光学、照相、电影、计量、检验、医疗或外科用仪器及设备、精密仪器及设备；上述物品的零件、附件,9026,液体或气体的流量、液位、压力或其他变化量的测量或检验仪器及装置（例如，流量计、液位计、压力表、热量计），但不包括品目9014、9015、9028或9032的仪器及装置,6,16252433262,12827561742,29079995004
90 ,第90章  光学、照相、电影、计量、检验、医疗或外科用仪器及设备、精密仪器及设备；上述物品的零件、附件,9027,理化分析仪器及装置（例如，偏振仪、折光仪、分光仪、气体或烟雾分析仪）；测量或检验粘性、多孔性、膨胀性、表面张力及类似性能的仪器及装置；测量或检验热量、声量或光量的仪器及装置（包括曝光表）；检镜切片机,14,52795507242,16836368676,69631875918
90 ,第90章  光学、照相、电影、计量、检验、医疗或外科用仪器及设备、精密仪器及设备；上述物品的零件、附件,9028,生产或供应气体、液体及电力用的计量仪表，包括它们的校准仪表,12,929393615,10894134534,11823528149
90 ,第90章  光学、照相、电影、计量、检验、医疗或外科用仪器及设备、精密仪器及设备；上述物品的零件、附件,9029,转数计、产量计数器、车费计、里程计、步数计及类似仪表；速度计及转速表，品目9014及9015的仪表除外；频闪观测仪,6,1098143186,3251459651,4349602837
90 ,第90章  光学、照相、电影、计量、检验、医疗或外科用仪器及设备、精密仪器及设备；上述物品的零件、附件,9030,示波器、频谱分析仪及其他用于电量测量或检验的仪器和装置，但不包括品目9028的各种仪表；α射线、β射线、γ射线、X射线、宇宙射线或其他粒子射线的测量或检验仪器及装置,18,22321725745,10776571198,33098296943
90 ,第90章  光学、照相、电影、计量、检验、医疗或外科用仪器及设备、精密仪器及设备；上述物品的零件、附件,9031,本章其他品目未列名的测量或检验仪器、器具及机器；轮廓投影仪,14,75827322153,32178225030,1.08006E+11
90 ,第90章  光学、照相、电影、计量、检验、医疗或外科用仪器及设备、精密仪器及设备；上述物品的零件、附件,9032,自动调节或控制仪器及装置,8,28130956593,26964726562,55095683155
90 ,第90章  光学、照相、电影、计量、检验、医疗或外科用仪器及设备、精密仪器及设备；上述物品的零件、附件,9033,第90章所列机器、器具、仪器或装置用的本章其他品目未列名的零件、附件,1,423015604,1584045140,2007060744
91 ,第91章  钟表及其零件,9101,手表、怀表及其他表，包括秒表，表壳用贵金属或包贵金属制成,7,5625063436,499604134,6124667570
91 ,第91章  钟表及其零件,9102,手表、怀表及其他表，包括秒表，但品目9101的货品除外,7,13574877385,9132388946,22707266331
91 ,第91章  钟表及其零件,9103,以表芯组装成的钟，但不包括品目9104的钟,2,3154364,12349341,15503705
91 ,第91章  钟表及其零件,9104,仪表板钟及车辆、航空器、航天器或船舶用的类似钟,1,6825800,51868851,58694651
91 ,第91章  钟表及其零件,9105,其他钟,7,51260575,4875161757,4926422332
91 ,第91章  钟表及其零件,9106,时间记录器以及测量、记录或指示时间间隔的装置，装有钟、表机芯或同步电动机的（例如，考勤钟、时刻记录器）,2,21380375,814716173,836096548
91 ,第91章  钟表及其零件,9107,装有钟、表机芯或同步电动机的定时开关,1,11862913,564127445,575990358
91 ,第91章  钟表及其零件,9108,已组装的完整表芯,6,1131798345,415196614,1546994959
91 ,第91章  钟表及其零件,9109,已组装的完整钟芯,2,13058024,132715614,145773638
91 ,第91章  钟表及其零件,9110,未组装或部分组装的完整钟、表机芯（机芯套装件）；已组装的不完整钟、表机芯；未组装的不完整钟、表机芯,5,75519421,238614174,314133595
91 ,第91章  钟表及其零件,9111,表壳及其零件,4,449603273,2399916138,2849519411
91 ,第91章  钟表及其零件,9112,钟壳和本章所列其他货品的类似外壳及其零件,2,1882876,56823219,58706095
91 ,第91章  钟表及其零件,9113,表带及其零件,3,574308422,2961440546,3535748968
91 ,第91章  钟表及其零件,9114,钟、表的其他零件,5,553653537,1169292789,1722946326
92 ,第92章  乐器及其零件、附件,9201,钢琴，包括自动钢琴；拨弦古钢琴及其他键盘弦乐器,3,1082431966,312653248,1395085214
92 ,第92章  乐器及其零件、附件,9202,其他弦乐器（例如，吉他、小提琴、竖琴）,2,184244848,2694433234,2878678082
92 ,第92章  乐器及其零件、附件,9205,管乐器，但游艺场风琴及手摇风琴除外,5,191653358,1036389805,1228043163
92 ,第92章  乐器及其零件、附件,9206,打击乐器（例如，鼓、木琴、铙、钹、响板、响葫芦）,1,68541767,908653943,977195710
92 ,第92章  乐器及其零件、附件,9207,通过电产生或扩大声音的乐器（例如，电风琴、电吉他、电手风琴）,2,590295864,3816419566,4406715430
92 ,第92章  乐器及其零件、附件,9208,百音盒、游艺场风琴、手摇风琴、机械鸣禽、乐锯及本章其他品目未列名的其他乐器；各种媒诱音响器、哨子、号角、口吹音响信号器,2,8717395,543997701,552715096
92 ,第92章  乐器及其零件、附件,9209,乐器的零件（例如，百音盒的机械装置）、附件（例如，机械乐器用的卡片、盘及带卷）；节拍器、音叉及各种定音管,7,622724693,1532449491,2155174184
93 ,第93章  武器、弹药及其零件、附件,9301,军用武器，但左轮手枪、其他手枪及品目9307的兵器除外,4,0,0,0
93 ,第93章  武器、弹药及其零件、附件,9302,左轮手枪及其他手枪，但品目9303或9304的货品除外,1,0,0,0
93 ,第93章  武器、弹药及其零件、附件,9303,靠爆炸药发射的其他火器及类似装置（例如，运动用猎枪及步枪、前装枪、维利式信号枪及其他转为发射信号弹的装置、发射空包弹的左轮手枪和其他手枪、弩枪式无痛捕杀器、抛缆枪）,4,4128215,39023937,43152152
93 ,第93章  武器、弹药及其零件、附件,9304,其他武器（例如，弹簧枪、气枪、气手枪、警棍），但不包括品目9307的货品,1,2750584,967786924,970537508
93 ,第93章  武器、弹药及其零件、附件,9305,品目9301至9304所列物品的零件、附件,4,2999202,174184113,177183315
93 ,第93章  武器、弹药及其零件、附件,9306,炸弹、手榴弹、鱼雷、地雷、水雷、导弹及类似武器及其零件；子弹、其他弹药和射弹及其零件，包括弹丸及弹垫,5,1897011,39565549,41462560
93 ,第93章  武器、弹药及其零件、附件,9307,剑、短弯刀、刺刀、长矛和类似的武器及其零件；刀鞘、剑鞘,2,281075,169156604,169437679
94 ,第94章  家具；寝具、褥垫、弹簧床垫、软坐垫及类似的填充制品；未列名灯具及照明装置；发光标志、发光铭牌及类似品；活动房屋,9401,坐具（包括能作床用的两用椅，但品目9402的货品除外）及其零件,23,5426958230,1.62636E+11,1.68063E+11
94 ,第94章  家具；寝具、褥垫、弹簧床垫、软坐垫及类似的填充制品；未列名灯具及照明装置；发光标志、发光铭牌及类似品；活动房屋,9402,医疗、外科、牙科或兽医用家具（例如，手术台、检查台、带机械装置的病床、牙科用椅）；有旋转、倾斜、升降装置的理发用椅及类似椅；上述物品的零件,3,502135889,6076724947,6578860836
94 ,第94章  家具；寝具、褥垫、弹簧床垫、软坐垫及类似的填充制品；未列名灯具及照明装置；发光标志、发光铭牌及类似品；活动房屋,9403,其他家具及其零件,18,4455648243,1.80482E+11,1.84938E+11
94 ,第94章  家具；寝具、褥垫、弹簧床垫、软坐垫及类似的填充制品；未列名灯具及照明装置；发光标志、发光铭牌及类似品；活动房屋,9404,弹簧床垫；寝具及类似用品，装有弹簧、内部用任何材料填充、衬垫或用海绵橡胶、泡沫塑料制成，不论是否包面（例如，褥垫、被子、羽绒被、靠垫、坐垫及枕头）,15,828676331,50567177543,51395853874
94 ,第94章  家具；寝具、褥垫、弹簧床垫、软坐垫及类似的填充制品；未列名灯具及照明装置；发光标志、发光铭牌及类似品；活动房屋,9405,"其他品目未列名的灯具及照明装置,包括探照灯、聚光灯及其零件;装有固定光源的发光标志、发光铭牌及类似品，以及其他处未列名的这些货品的零件",17,2200089317,2.24012E+11,2.26212E+11
94 ,第94章  家具；寝具、褥垫、弹簧床垫、软坐垫及类似的填充制品；未列名灯具及照明装置；发光标志、发光铭牌及类似品；活动房屋,9406,活动房屋,3,429890374,14613930395,15043820769
95 ,第95章  玩具、游戏品、运动用品及其零件、附件,9503,三轮车、踏板车、踏板汽车及类似的带轮玩具；玩偶车；玩偶；其他玩具；缩小（按比例缩小）的模型及类似的娱乐用模型，不论是否活动；各种智力玩具,7,3948748373,2.42399E+11,2.46348E+11
95 ,第95章  玩具、游戏品、运动用品及其零件、附件,9504,视频游戏控制器及设备，桌上或室内游戏，包括弹球机、台球、娱乐专用桌及保龄球自动球道设备，用硬币、钞票、银行卡、代币或任何其他支付方式使其工作的游乐机器,15,4240083080,93803763732,98043846812
95 ,第95章  玩具、游戏品、运动用品及其零件、附件,9505,节日（包括狂欢节）用品或其他娱乐用品，包括魔术道具及嬉戏品,2,28358944,85167789481,85196148425
95 ,第95章  玩具、游戏品、运动用品及其零件、附件,9506,一般的体育活动、体操、竞技及其他运动（包括乒乓球运动）或户外游戏用本章其他品目未列名的用品及设备；游泳池或戏水池,23,3470049096,89776745573,93246794669
95 ,第95章  玩具、游戏品、运动用品及其零件、附件,9507,钓鱼竿、钓鱼钩及其他钓鱼用品；捞鱼网、捕蝶网及类似网；?子“鸟”（品目9208或9705的货品除外）以及类似的狩猎用品,4,1232053695,11825995832,13058049527
95 ,第95章  玩具、游戏品、运动用品及其零件、附件,9508,流动马戏团及流动动物园；游乐场乘骑游乐设施和水上乐园娱乐设备；游乐场娱乐设备，包括射击用靶；流动剧团,10,447728635,268994395,716723030
96 ,第96章  杂项制品,9601,已加工的兽牙、骨、龟壳、角、鹿角、珊瑚、珍珠母及其他动物质雕刻材料及其制品（包括塑模制品）,2,25523527,273445258,298968785
96 ,第96章  杂项制品,9602,已加工的植物质或矿物质雕刻材料及其制品；蜡、硬脂、天然树胶、天然树脂或塑型膏制成的模塑或雕刻制品以及其他品目未列名的模塑或雕刻制品；已加工的未硬化明胶（品目3503的明胶除外）及未硬化明胶制品,2,29291122,1156896195,1186187317
96 ,第96章  杂项制品,9603,帚、刷（包括作为机器、器具、车辆零件的刷）、非机动的手工操作地板清扫器、拖把及毛掸；供制帚、刷用的成束或成簇的材料；油漆块垫及滚筒；橡皮扫帚（橡皮辊除外）,15,1049826616,33992754622,35042581238
96 ,第96章  杂项制品,9604,手用粗筛、细筛,1,534605,18782331,19316936
96 ,第96章  杂项制品,9605,个人梳妆、缝纫或清洁鞋靴、衣服用的成套旅行用具,1,6581669,961088679,967670348
96 ,第96章  杂项制品,9606,钮扣、揿扣、钮扣芯及钮扣和揿扣的其他零件；钮扣坯,5,395253767,4019341109,4414594876
96 ,第96章  杂项制品,9607,拉链及其零件,3,987535230,8651114492,9638649722
96 ,第96章  杂项制品,9608,圆珠笔；毡尖及其他渗水式笔尖笔及唛头笔；自来水笔、铁笔型自来水笔及其他钢笔；蜡纸铁笔；活动铅笔；钢笔杆、铅笔杆及类似的笔杆；上述物品的零件（包括帽、夹），但品目9609的货品除外,12,1448040942,11234725376,12682766318
96 ,第96章  杂项制品,9609,铅笔（品目9608的铅笔除外）、颜色铅笔、铅笔芯、蜡笔、图画碳笔、书写或绘画用粉笔及裁缝划粉,4,142980540,4296547394,4439527934
96 ,第96章  杂项制品,9610,具有书写或绘画面的石板、黑板及类似板，不论是否镶框,1,6483627,2767919911,2774403538
96 ,第96章  杂项制品,9611,手用日期戳、封缄戳、品目戳、品目戳及类似印戳（包括标签压印器）；手工操作的排字盘及带有排字盘的手印器,1,18263504,329150747,347414251
96 ,第96章  杂项制品,9612,打字机色带或类似色带，以上油或经其他方法处理能着色的，不论是否装釉或装盒；印台，不论是否已加印油或带盒子,2,658875258,1246272903,1905148161
96 ,第96章  杂项制品,9613,香烟打火机和其他打火器（不论是机械的，还是电气的）及其零件，但打火石及打火机芯除外,4,260830183,5728168855,5988999038
96 ,第96章  杂项制品,9614,烟斗（包括烟斗头）和烟嘴及其零件,2,20662440,1173688107,1194350547
96 ,第96章  杂项制品,9615,梳子、发夹及类似品；发卡、卷发夹、卷发器或类似品及其零件，但品目8516的货品除外,3,240180930,10812623031,11052803961
96 ,第96章  杂项制品,9616,香水喷雾器或类似的化妆用喷雾器及其座架、喷头；粉扑及粉拍，施敷脂粉或化妆品用,2,104916524,4112230932,4217147456
96 ,第96章  杂项制品,9617,保温瓶和其他真空容器及其零件，但玻璃瓶胆除外,3,509647677,20499913073,21009560750
96 ,第96章  杂项制品,9618,裁缝用人体模型及其他人体活动模型；橱窗装饰用自动模型及其他活动陈列室,1,55541321,1844359045,1899900366
96 ,第96章  杂项制品,9619,任何材料制的卫生巾（护垫）及卫生棉条、尿布及尿布衬里和类似品,4,2179090405,14322075633,16501166038
96 ,第96章  杂项制品,9620,独脚架、双脚架、三脚架及类似品,2,66362000,2112142008,2178504008
97 ,第97章  艺术品、收藏品及古物,9701,油画、粉画及其他手绘画，但带有手工绘制及手工描饰的制品或品目4906的图纸除外；拼贴画、镶嵌画及类似装饰板,8,4053836405,6666723937,10720560342
97 ,第97章  艺术品、收藏品及古物,9702,雕版画、印制画、石印画的原本,2,13701264,11286603,24987867
97 ,第97章  艺术品、收藏品及古物,9703,各种材料制的雕塑品原件,2,437362283,544347388,981709671
97 ,第97章  艺术品、收藏品及古物,9704,使用过或未使用过的邮票、印花税票、邮戳印记、首日封、邮政信笺（印有邮票的纸品）及类似品，但品目4907的货品除外,2,40190974,70358,40261332
97 ,第97章  艺术品、收藏品及古物,9705,具有考古学、人种学、历史学、动物学、植物学、矿物学、解剖学、古生物学或钱币学意义的收集品及珍藏品,6,35160093,3600261,38760354
97 ,第97章  艺术品、收藏品及古物,9706,超过100年的古物,2,429279511,1421301214,1850580725
98 ,第98章  特殊交易品及未分类商品,9801,未分类商品,2,5174504,249303954,254478458
98 ,第98章  特殊交易品及未分类商品,9802,流通中的货币现钞（包括纸币及硬币）,2,0,0,0
98 ,第98章  特殊交易品及未分类商品,9803,定制型软件、检测报告、蓝图及类似品（仅用于出口）,2,0,0,0
98 ,第98章  特殊交易品及未分类商品,9804,低值简易通关商品,1,23138399754,1.65149E+11,1.88287E+11
98 ,第98章  特殊交易品及未分类商品,9805,个人跨境电商商品,1,14091227070,5927372198,20018599268
99 ,跨境电商B2B简化申报商品,9900,跨境电商B2B简化申报商品,1,0,19616071595,19616071595