ISO_N3,country_name,province_code,province_name,e,i,ie
004,阿富汗,11,北京市,34476300 ,383563 ,34859863 
004,阿富汗,12,天津市,17569340 ,14083203 ,31652543 
004,阿富汗,13,河北省,48597823 ,0 ,48597823 
004,阿富汗,14,山西省,16799 ,0 ,16799 
004,阿富汗,15,内蒙古自治区,6304057 ,0 ,6304057 
004,阿富汗,21,辽宁省,1479990 ,330344 ,1810334 
004,阿富汗,22,吉林省,0 ,625842 ,625842 
004,阿富汗,23,黑龙江省,1194011 ,957242 ,2151253 
004,阿富汗,31,上海市,9294143 ,4477027 ,13771170 
004,阿富汗,32,江苏省,254390725 ,1172981 ,255563706 
004,阿富汗,33,浙江省,926072685 ,24510258 ,950582943 
004,阿富汗,34,安徽省,22227078 ,0 ,22227078 
004,阿富汗,35,福建省,35789979 ,72399 ,35862378 
004,阿富汗,36,江西省,20477627 ,179687 ,20657314 
004,阿富汗,37,山东省,494505483 ,11331681 ,505837164 
004,阿富汗,41,河南省,13387385 ,10005 ,13397390 
004,阿富汗,42,湖北省,26491756 ,4687 ,26496443 
004,阿富汗,43,湖南省,58407811 ,0 ,58407811 
004,阿富汗,44,广东省,398320495 ,7721209 ,406041704 
004,阿富汗,45,广西壮族自治区,63756445 ,0 ,63756445 
004,阿富汗,50,重庆市,15261805 ,0 ,15261805 
004,阿富汗,51,四川省,13934382 ,47542 ,13981924 
004,阿富汗,52,贵州省,469 ,0 ,469 
004,阿富汗,53,云南省,628946 ,0 ,628946 
004,阿富汗,54,西藏自治区,548 ,0 ,548 
004,阿富汗,61,陕西省,24018737 ,222 ,24018959 
004,阿富汗,62,甘肃省,1558193 ,0 ,1558193 
004,阿富汗,65,新疆维吾尔自治区,28838727 ,0 ,28838727 
008,阿尔巴尼亚,11,北京市,29069588 ,127977006 ,157046594 
008,阿尔巴尼亚,12,天津市,20307861 ,11182050 ,31489911 
008,阿尔巴尼亚,13,河北省,56971066 ,74055031 ,131026097 
008,阿尔巴尼亚,14,山西省,1812080 ,14435643 ,16247723 
008,阿尔巴尼亚,15,内蒙古自治区,1257186 ,0 ,1257186 
008,阿尔巴尼亚,21,辽宁省,6856825 ,17048826 ,23905651 
008,阿尔巴尼亚,22,吉林省,6993760 ,0 ,6993760 
008,阿尔巴尼亚,23,黑龙江省,2728489 ,98160 ,2826649 
008,阿尔巴尼亚,31,上海市,73288550 ,106543423 ,179831973 
008,阿尔巴尼亚,32,江苏省,315916887 ,61184007 ,377100894 
008,阿尔巴尼亚,33,浙江省,1303030873 ,121830884 ,1424861757 
008,阿尔巴尼亚,34,安徽省,40684262 ,5529073 ,46213335 
008,阿尔巴尼亚,35,福建省,105148492 ,421574017 ,526722509 
008,阿尔巴尼亚,36,江西省,64019881 ,0 ,64019881 
008,阿尔巴尼亚,37,山东省,298408750 ,17305962 ,315714712 
008,阿尔巴尼亚,41,河南省,38551945 ,279358 ,38831303 
008,阿尔巴尼亚,42,湖北省,21862228 ,128568 ,21990796 
008,阿尔巴尼亚,43,湖南省,78723207 ,7278008 ,86001215 
008,阿尔巴尼亚,44,广东省,537976937 ,52760472 ,590737409 
008,阿尔巴尼亚,45,广西壮族自治区,7282403 ,637 ,7283040 
008,阿尔巴尼亚,46,海南省,25832440 ,3097736 ,28930176 
008,阿尔巴尼亚,50,重庆市,44083004 ,3795767 ,47878771 
008,阿尔巴尼亚,51,四川省,24376291 ,15909427 ,40285718 
008,阿尔巴尼亚,52,贵州省,7933726 ,0 ,7933726 
008,阿尔巴尼亚,53,云南省,19081217 ,112755 ,19193972 
008,阿尔巴尼亚,61,陕西省,3672979 ,3100209 ,6773188 
008,阿尔巴尼亚,62,甘肃省,2902290 ,28648136 ,31550426 
008,阿尔巴尼亚,64,宁夏回族自治区,1074338 ,0 ,1074338 
008,阿尔巴尼亚,65,新疆维吾尔自治区,924658 ,13986907 ,14911565 
012,阿尔及利亚,11,北京市,1110777822 ,3330262034 ,4441039856 
012,阿尔及利亚,12,天津市,269307743 ,2475445 ,271783188 
012,阿尔及利亚,13,河北省,533930157 ,2474066 ,536404223 
012,阿尔及利亚,14,山西省,45239302 ,0 ,45239302 
012,阿尔及利亚,15,内蒙古自治区,83194160 ,0 ,83194160 
012,阿尔及利亚,21,辽宁省,254589747 ,1353 ,254591100 
012,阿尔及利亚,22,吉林省,18877210 ,0 ,18877210 
012,阿尔及利亚,23,黑龙江省,26312076 ,0 ,26312076 
012,阿尔及利亚,31,上海市,913420258 ,3615335 ,917035593 
012,阿尔及利亚,32,江苏省,2636977880 ,152297856 ,2789275736 
012,阿尔及利亚,33,浙江省,9265639516 ,447163500 ,9712803016 
012,阿尔及利亚,34,安徽省,568440179 ,4896 ,568445075 
012,阿尔及利亚,35,福建省,1688858744 ,294915960 ,1983774704 
012,阿尔及利亚,36,江西省,431254834 ,5174701 ,436429535 
012,阿尔及利亚,37,山东省,3039275881 ,1487209141 ,4526485022 
012,阿尔及利亚,41,河南省,257111756 ,199800 ,257311556 
012,阿尔及利亚,42,湖北省,477165731 ,6085 ,477171816 
012,阿尔及利亚,43,湖南省,1186650192 ,839 ,1186651031 
012,阿尔及利亚,44,广东省,5013420888 ,2562055 ,5015982943 
012,阿尔及利亚,45,广西壮族自治区,79976076 ,400 ,79976476 
012,阿尔及利亚,46,海南省,282351793 ,699 ,282352492 
012,阿尔及利亚,50,重庆市,164700278 ,0 ,164700278 
012,阿尔及利亚,51,四川省,479550612 ,14015 ,479564627 
012,阿尔及利亚,52,贵州省,30789109 ,3251 ,30792360 
012,阿尔及利亚,53,云南省,104388235 ,0 ,104388235 
012,阿尔及利亚,61,陕西省,31690879 ,7822 ,31698701 
012,阿尔及利亚,62,甘肃省,5358986 ,0 ,5358986 
012,阿尔及利亚,63,青海省,10522644 ,172 ,10522816 
012,阿尔及利亚,64,宁夏回族自治区,9553119 ,0 ,9553119 
012,阿尔及利亚,65,新疆维吾尔自治区,18643380 ,0 ,18643380 
016,萨摩亚,11,北京市,29137227 ,8212 ,29145439 
016,萨摩亚,12,天津市,6430752 ,0 ,6430752 
016,萨摩亚,13,河北省,5891535 ,0 ,5891535 
016,萨摩亚,21,辽宁省,1829142 ,781 ,1829923 
016,萨摩亚,23,黑龙江省,432189 ,0 ,432189 
016,萨摩亚,31,上海市,12527873 ,385135 ,12913008 
016,萨摩亚,32,江苏省,16971863 ,6 ,16971869 
016,萨摩亚,33,浙江省,166163705 ,0 ,166163705 
016,萨摩亚,34,安徽省,9432362 ,0 ,9432362 
016,萨摩亚,35,福建省,60018211 ,80 ,60018291 
016,萨摩亚,36,江西省,18324883 ,0 ,18324883 
016,萨摩亚,37,山东省,92602871 ,4321827 ,96924698 
016,萨摩亚,41,河南省,5357187 ,0 ,5357187 
016,萨摩亚,42,湖北省,17015395 ,0 ,17015395 
016,萨摩亚,43,湖南省,21770597 ,0 ,21770597 
016,萨摩亚,44,广东省,119059261 ,911918 ,119971179 
016,萨摩亚,45,广西壮族自治区,2896915 ,0 ,2896915 
016,萨摩亚,50,重庆市,1690292 ,0 ,1690292 
016,萨摩亚,51,四川省,10260601 ,2608 ,10263209 
016,萨摩亚,52,贵州省,238483 ,0 ,238483 
016,萨摩亚,53,云南省,7101800 ,0 ,7101800 
016,萨摩亚,61,陕西省,9306118 ,0 ,9306118 
016,萨摩亚,62,甘肃省,1338613 ,0 ,1338613 
016,萨摩亚,65,新疆维吾尔自治区,1919189 ,0 ,1919189 
020,安道尔,11,北京市,267816 ,93921 ,361737 
020,安道尔,12,天津市,3809064 ,209222 ,4018286 
020,安道尔,13,河北省,114810 ,0 ,114810 
020,安道尔,14,山西省,2532 ,0 ,2532 
020,安道尔,21,辽宁省,0 ,2187 ,2187 
020,安道尔,31,上海市,1443033 ,152962 ,1595995 
020,安道尔,32,江苏省,2592973 ,135187 ,2728160 
020,安道尔,33,浙江省,2038954 ,36240 ,2075194 
020,安道尔,34,安徽省,1522385 ,0 ,1522385 
020,安道尔,35,福建省,186671 ,909 ,187580 
020,安道尔,36,江西省,1948397 ,0 ,1948397 
020,安道尔,37,山东省,4288972 ,3390 ,4292362 
020,安道尔,42,湖北省,33903 ,0 ,33903 
020,安道尔,44,广东省,75241207 ,269228 ,75510435 
020,安道尔,45,广西壮族自治区,418186 ,0 ,418186 
020,安道尔,51,四川省,14430 ,1943 ,16373 
020,安道尔,61,陕西省,173051 ,7678 ,180729 
024,安哥拉,11,北京市,754201045 ,90242113011 ,90996314056 
024,安哥拉,12,天津市,322473652 ,2817794 ,325291446 
024,安哥拉,13,河北省,542407885 ,171061 ,542578946 
024,安哥拉,14,山西省,18092161 ,0 ,18092161 
024,安哥拉,15,内蒙古自治区,8455118 ,0 ,8455118 
024,安哥拉,21,辽宁省,104550546 ,594 ,104551140 
024,安哥拉,22,吉林省,36170086 ,0 ,36170086 
024,安哥拉,23,黑龙江省,23426230 ,0 ,23426230 
024,安哥拉,31,上海市,340726933 ,261212861 ,601939794 
024,安哥拉,32,江苏省,1365012714 ,29869915 ,1394882629 
024,安哥拉,33,浙江省,4332613899 ,4035503526 ,8368117425 
024,安哥拉,34,安徽省,634666546 ,4010148 ,638676694 
024,安哥拉,35,福建省,878006139 ,369002632 ,1247008771 
024,安哥拉,36,江西省,662348695 ,6155563 ,668504258 
024,安哥拉,37,山东省,2310542362 ,16026238004 ,18336780366 
024,安哥拉,41,河南省,294668938 ,0 ,294668938 
024,安哥拉,42,湖北省,460138886 ,4617012177 ,5077151063 
024,安哥拉,43,湖南省,751162410 ,3963279 ,755125689 
024,安哥拉,44,广东省,3125340193 ,4152604092 ,7277944285 
024,安哥拉,45,广西壮族自治区,138007454 ,79040000 ,217047454 
024,安哥拉,46,海南省,22598891 ,0 ,22598891 
024,安哥拉,50,重庆市,531247986 ,51 ,531248037 
024,安哥拉,51,四川省,452855068 ,3457 ,452858525 
024,安哥拉,52,贵州省,20031667 ,12960393 ,32992060 
024,安哥拉,53,云南省,135592810 ,0 ,135592810 
024,安哥拉,61,陕西省,270026277 ,0 ,270026277 
024,安哥拉,62,甘肃省,1964104 ,0 ,1964104 
024,安哥拉,63,青海省,3546669 ,0 ,3546669 
024,安哥拉,64,宁夏回族自治区,1003503 ,0 ,1003503 
024,安哥拉,65,新疆维吾尔自治区,11750616 ,0 ,11750616 
028,安提瓜和巴布达,11,北京市,103866937 ,6806 ,103873743 
028,安提瓜和巴布达,12,天津市,44069813 ,0 ,44069813 
028,安提瓜和巴布达,13,河北省,2615253 ,0 ,2615253 
028,安提瓜和巴布达,21,辽宁省,2688444 ,0 ,2688444 
028,安提瓜和巴布达,23,黑龙江省,20226 ,0 ,20226 
028,安提瓜和巴布达,31,上海市,6962378 ,1371953 ,8334331 
028,安提瓜和巴布达,32,江苏省,39616537 ,956 ,39617493 
028,安提瓜和巴布达,33,浙江省,158646996 ,0 ,158646996 
028,安提瓜和巴布达,34,安徽省,2466840 ,0 ,2466840 
028,安提瓜和巴布达,35,福建省,5543395 ,0 ,5543395 
028,安提瓜和巴布达,36,江西省,5929072 ,0 ,5929072 
028,安提瓜和巴布达,37,山东省,25500754 ,0 ,25500754 
028,安提瓜和巴布达,41,河南省,1244879 ,0 ,1244879 
028,安提瓜和巴布达,42,湖北省,14480514 ,0 ,14480514 
028,安提瓜和巴布达,43,湖南省,3352230 ,0 ,3352230 
028,安提瓜和巴布达,44,广东省,118457124 ,4186775 ,122643899 
028,安提瓜和巴布达,45,广西壮族自治区,42297 ,0 ,42297 
028,安提瓜和巴布达,46,海南省,0 ,23882 ,23882 
028,安提瓜和巴布达,50,重庆市,2002169 ,0 ,2002169 
028,安提瓜和巴布达,51,四川省,271282 ,0 ,271282 
028,安提瓜和巴布达,53,云南省,1228409 ,0 ,1228409 
031,阿塞拜疆,11,北京市,132491337 ,852205809 ,984697146 
031,阿塞拜疆,12,天津市,37207406 ,78691332 ,115898738 
031,阿塞拜疆,13,河北省,105296542 ,16780363 ,122076905 
031,阿塞拜疆,14,山西省,1914656 ,0 ,1914656 
031,阿塞拜疆,15,内蒙古自治区,4835128 ,0 ,4835128 
031,阿塞拜疆,21,辽宁省,22846143 ,2564854 ,25410997 
031,阿塞拜疆,22,吉林省,28451316 ,0 ,28451316 
031,阿塞拜疆,23,黑龙江省,44555710 ,110147183 ,154702893 
031,阿塞拜疆,31,上海市,432244003 ,1276314 ,433520317 
031,阿塞拜疆,32,江苏省,366314540 ,24598136 ,390912676 
031,阿塞拜疆,33,浙江省,1820194699 ,58631122 ,1878825821 
031,阿塞拜疆,34,安徽省,75745999 ,2828746 ,78574745 
031,阿塞拜疆,35,福建省,37116710 ,10233884 ,47350594 
031,阿塞拜疆,36,江西省,30533123 ,4199023 ,34732146 
031,阿塞拜疆,37,山东省,606046260 ,149358773 ,755405033 
031,阿塞拜疆,41,河南省,61456199 ,0 ,61456199 
031,阿塞拜疆,42,湖北省,56995172 ,0 ,56995172 
031,阿塞拜疆,43,湖南省,89746400 ,0 ,89746400 
031,阿塞拜疆,44,广东省,1091524001 ,84341882 ,1175865883 
031,阿塞拜疆,45,广西壮族自治区,46881714 ,0 ,46881714 
031,阿塞拜疆,46,海南省,5837315 ,0 ,5837315 
031,阿塞拜疆,50,重庆市,155117871 ,0 ,155117871 
031,阿塞拜疆,51,四川省,39721127 ,14118 ,39735245 
031,阿塞拜疆,52,贵州省,2981502 ,0 ,2981502 
031,阿塞拜疆,53,云南省,6964655 ,0 ,6964655 
031,阿塞拜疆,61,陕西省,10677792 ,0 ,10677792 
031,阿塞拜疆,62,甘肃省,14984381 ,2443296 ,17427677 
031,阿塞拜疆,64,宁夏回族自治区,8636241 ,0 ,8636241 
031,阿塞拜疆,65,新疆维吾尔自治区,171955038 ,527206 ,172482244 
032,阿根廷,11,北京市,629214985 ,3566972416 ,4196187401 
032,阿根廷,12,天津市,1060489860 ,2256444074 ,3316933934 
032,阿根廷,13,河北省,1066586980 ,107052071 ,1173639051 
032,阿根廷,14,山西省,34268476 ,104681928 ,138950404 
032,阿根廷,15,内蒙古自治区,224442439 ,27549103 ,251991542 
032,阿根廷,21,辽宁省,484908248 ,1138415899 ,1623324147 
032,阿根廷,22,吉林省,41291504 ,29461627 ,70753131 
032,阿根廷,23,黑龙江省,79761829 ,713252166 ,793013995 
032,阿根廷,31,上海市,3598041673 ,3987745247 ,7585786920 
032,阿根廷,32,江苏省,10508742031 ,3138462188 ,13647204219 
032,阿根廷,33,浙江省,13589542197 ,1398024370 ,14987566567 
032,阿根廷,34,安徽省,1358044619 ,738717850 ,2096762469 
032,阿根廷,35,福建省,2763541912 ,4387064138 ,7150606050 
032,阿根廷,36,江西省,1282006274 ,50080448 ,1332086722 
032,阿根廷,37,山东省,5578915835 ,4569214606 ,10148130441 
032,阿根廷,41,河南省,546589535 ,333269319 ,879858854 
032,阿根廷,42,湖北省,5244451117 ,681778376 ,5926229493 
032,阿根廷,43,湖南省,897069456 ,428022356 ,1325091812 
032,阿根廷,44,广东省,11941059828 ,5115383417 ,17056443245 
032,阿根廷,45,广西壮族自治区,461858698 ,386990681 ,848849379 
032,阿根廷,46,海南省,69841420 ,387135072 ,456976492 
032,阿根廷,50,重庆市,1315364527 ,310715878 ,1626080405 
032,阿根廷,51,四川省,1638393745 ,385195515 ,2023589260 
032,阿根廷,52,贵州省,172684494 ,117125165 ,289809659 
032,阿根廷,53,云南省,1835903406 ,38589747 ,1874493153 
032,阿根廷,54,西藏自治区,72862863 ,0 ,72862863 
032,阿根廷,61,陕西省,244136018 ,275186925 ,519322943 
032,阿根廷,62,甘肃省,23373203 ,28260296 ,51633499 
032,阿根廷,64,宁夏回族自治区,123380856 ,12551578 ,135932434 
032,阿根廷,65,新疆维吾尔自治区,65877178 ,0 ,65877178 
036,澳大利亚,11,北京市,8456735310 ,125330114424 ,133786849734 
036,澳大利亚,12,天津市,7483736613 ,12038722284 ,19522458897 
036,澳大利亚,13,河北省,6661585972 ,48365234671 ,55026820643 
036,澳大利亚,14,山西省,1825468386 ,3896247002 ,5721715388 
036,澳大利亚,15,内蒙古自治区,427505988 ,6156975965 ,6584481953 
036,澳大利亚,21,辽宁省,4865516768 ,21106874980 ,25972391748 
036,澳大利亚,22,吉林省,467603297 ,147363746 ,614967043 
036,澳大利亚,23,黑龙江省,617747977 ,3068038463 ,3685786440 
036,澳大利亚,31,上海市,37338660434 ,100478935286 ,137817595720 
036,澳大利亚,32,江苏省,61624236663 ,65596329885 ,127220566548 
036,澳大利亚,33,浙江省,57665876337 ,61964825368 ,119630701705 
036,澳大利亚,34,安徽省,6375464899 ,10604297488 ,16979762387 
036,澳大利亚,35,福建省,17116980128 ,49807099903 ,66924080031 
036,澳大利亚,36,江西省,6123007577 ,14735247261 ,20858254838 
036,澳大利亚,37,山东省,40946530325 ,55704253593 ,96650783918 
036,澳大利亚,41,河南省,8144234649 ,9959803129 ,18104037778 
036,澳大利亚,42,湖北省,4956768636 ,7928083838 ,12884852474 
036,澳大利亚,43,湖南省,7469949392 ,14973566643 ,22443516035 
036,澳大利亚,44,广东省,80332546363 ,43033565213 ,123366111576 
036,澳大利亚,45,广西壮族自治区,2569180362 ,9880211393 ,12449391755 
036,澳大利亚,46,海南省,321036266 ,13268614265 ,13589650531 
036,澳大利亚,50,重庆市,6535236696 ,9832922471 ,16368159167 
036,澳大利亚,51,四川省,7990841429 ,13879964955 ,21870806384 
036,澳大利亚,52,贵州省,1518680727 ,1833677868 ,3352358595 
036,澳大利亚,53,云南省,2038272531 ,3116628149 ,5154900680 
036,澳大利亚,54,西藏自治区,4628680 ,0 ,4628680 
036,澳大利亚,61,陕西省,1443744328 ,5852475132 ,7296219460 
036,澳大利亚,62,甘肃省,122214695 ,2780560695 ,2902775390 
036,澳大利亚,63,青海省,21403115 ,49399021 ,70802136 
036,澳大利亚,64,宁夏回族自治区,94507048 ,96499081 ,191006129 
036,澳大利亚,65,新疆维吾尔自治区,276484163 ,70895850 ,347380013 
040,奥地利,11,北京市,2347688936 ,8906531081 ,11254220017 
040,奥地利,12,天津市,391885432 ,3239084255 ,3630969687 
040,奥地利,13,河北省,377791352 ,337965552 ,715756904 
040,奥地利,14,山西省,91057723 ,140027897 ,231085620 
040,奥地利,15,内蒙古自治区,5877947 ,19338391 ,25216338 
040,奥地利,21,辽宁省,416454673 ,2892913768 ,3309368441 
040,奥地利,22,吉林省,44000179 ,401916805 ,445916984 
040,奥地利,23,黑龙江省,33037601 ,82966479 ,116004080 
040,奥地利,31,上海市,1980213520 ,8409700303 ,10389913823 
040,奥地利,32,江苏省,3611575283 ,5362099197 ,8973674480 
040,奥地利,33,浙江省,4750110373 ,1864063797 ,6614174170 
040,奥地利,34,安徽省,974891007 ,514164586 ,1489055593 
040,奥地利,35,福建省,765097567 ,448456699 ,1213554266 
040,奥地利,36,江西省,127694831 ,180350126 ,308044957 
040,奥地利,37,山东省,1151997222 ,1696915522 ,2848912744 
040,奥地利,41,河南省,917051659 ,105322654 ,1022374313 
040,奥地利,42,湖北省,162555980 ,789906311 ,952462291 
040,奥地利,43,湖南省,196286295 ,298906116 ,495192411 
040,奥地利,44,广东省,5398883838 ,4248755039 ,9647638877 
040,奥地利,45,广西壮族自治区,49661816 ,73778869 ,123440685 
040,奥地利,46,海南省,28409943 ,72272466 ,100682409 
040,奥地利,50,重庆市,970664698 ,712051461 ,1682716159 
040,奥地利,51,四川省,332091262 ,295868938 ,627960200 
040,奥地利,52,贵州省,3729559 ,38633273 ,42362832 
040,奥地利,53,云南省,5795742 ,39909023 ,45704765 
040,奥地利,54,西藏自治区,2429 ,38118 ,40547 
040,奥地利,61,陕西省,382797434 ,178176829 ,560974263 
040,奥地利,62,甘肃省,844885 ,20481014 ,21325899 
040,奥地利,63,青海省,47653 ,2059171 ,2106824 
040,奥地利,64,宁夏回族自治区,75310197 ,7155489 ,82465686 
040,奥地利,65,新疆维吾尔自治区,32734852 ,56159508 ,88894360 
044,巴哈马,11,北京市,435021866 ,19079 ,435040945 
044,巴哈马,12,天津市,53452398 ,8662 ,53461060 
044,巴哈马,13,河北省,12569185 ,0 ,12569185 
044,巴哈马,14,山西省,254247 ,0 ,254247 
044,巴哈马,21,辽宁省,20137638 ,0 ,20137638 
044,巴哈马,23,黑龙江省,93179 ,0 ,93179 
044,巴哈马,31,上海市,68812759 ,55917 ,68868676 
044,巴哈马,32,江苏省,169493680 ,11743 ,169505423 
044,巴哈马,33,浙江省,683922379 ,58583542 ,742505921 
044,巴哈马,34,安徽省,11643947 ,0 ,11643947 
044,巴哈马,35,福建省,29873096 ,274123 ,30147219 
044,巴哈马,36,江西省,15217465 ,0 ,15217465 
044,巴哈马,37,山东省,91988283 ,34 ,91988317 
044,巴哈马,41,河南省,2873906 ,0 ,2873906 
044,巴哈马,42,湖北省,37320979 ,0 ,37320979 
044,巴哈马,43,湖南省,30968089 ,0 ,30968089 
044,巴哈马,44,广东省,218213455 ,507654 ,218721109 
044,巴哈马,45,广西壮族自治区,10856118 ,0 ,10856118 
044,巴哈马,46,海南省,0 ,5359 ,5359 
044,巴哈马,50,重庆市,3019308 ,18344 ,3037652 
044,巴哈马,51,四川省,7207763 ,0 ,7207763 
044,巴哈马,52,贵州省,277904 ,0 ,277904 
044,巴哈马,53,云南省,6027176 ,0 ,6027176 
044,巴哈马,61,陕西省,652560 ,0 ,652560 
044,巴哈马,64,宁夏回族自治区,1347071 ,0 ,1347071 
044,巴哈马,65,新疆维吾尔自治区,5158 ,0 ,5158 
048,巴林,11,北京市,77849155 ,430901785 ,508750940 
048,巴林,12,天津市,59653951 ,13343660 ,72997611 
048,巴林,13,河北省,845030392 ,19046 ,845049438 
048,巴林,14,山西省,36845666 ,0 ,36845666 
048,巴林,15,内蒙古自治区,6283329 ,0 ,6283329 
048,巴林,21,辽宁省,99238040 ,34881 ,99272921 
048,巴林,22,吉林省,45758534 ,410 ,45758944 
048,巴林,23,黑龙江省,31786860 ,19519 ,31806379 
048,巴林,31,上海市,662324749 ,353973954 ,1016298703 
048,巴林,32,江苏省,750715655 ,249691407 ,1000407062 
048,巴林,33,浙江省,992234341 ,239295319 ,1231529660 
048,巴林,34,安徽省,194011240 ,1054690 ,195065930 
048,巴林,35,福建省,192203863 ,40265 ,192244128 
048,巴林,36,江西省,231126195 ,0 ,231126195 
048,巴林,37,山东省,2598127550 ,73268264 ,2671395814 
048,巴林,41,河南省,272699532 ,1670 ,272701202 
048,巴林,42,湖北省,163974575 ,1264 ,163975839 
048,巴林,43,湖南省,193153864 ,0 ,193153864 
048,巴林,44,广东省,1601985294 ,2504337 ,1604489631 
048,巴林,45,广西壮族自治区,57736403 ,0 ,57736403 
048,巴林,46,海南省,941776 ,0 ,941776 
048,巴林,50,重庆市,159203542 ,907500 ,160111042 
048,巴林,51,四川省,60765895 ,57053 ,60822948 
048,巴林,52,贵州省,1626652 ,30953870 ,32580522 
048,巴林,53,云南省,61236653 ,0 ,61236653 
048,巴林,61,陕西省,44658608 ,336 ,44658944 
048,巴林,62,甘肃省,13781927 ,0 ,13781927 
048,巴林,63,青海省,315407 ,0 ,315407 
048,巴林,65,新疆维吾尔自治区,12397771 ,0 ,12397771 
050,孟加拉国,11,北京市,11824808967 ,319243912 ,12144052879 
050,孟加拉国,12,天津市,1419159328 ,11212727 ,1430372055 
050,孟加拉国,13,河北省,2336117597 ,122058761 ,2458176358 
050,孟加拉国,14,山西省,422399866 ,488 ,422400354 
050,孟加拉国,15,内蒙古自治区,598423679 ,0 ,598423679 
050,孟加拉国,21,辽宁省,1515587567 ,119436193 ,1635023760 
050,孟加拉国,22,吉林省,149179829 ,93950 ,149273779 
050,孟加拉国,23,黑龙江省,217001682 ,243482 ,217245164 
050,孟加拉国,31,上海市,7013343426 ,1709588259 ,8722931685 
050,孟加拉国,32,江苏省,24616669010 ,418516245 ,25035185255 
050,孟加拉国,33,浙江省,24847869821 ,589478286 ,25437348107 
050,孟加拉国,34,安徽省,1969159758 ,37759851 ,2006919609 
050,孟加拉国,35,福建省,5867189496 ,86587205 ,5953776701 
050,孟加拉国,36,江西省,3195475365 ,44462299 ,3239937664 
050,孟加拉国,37,山东省,9405185955 ,202971155 ,9608157110 
050,孟加拉国,41,河南省,1041909340 ,299072786 ,1340982126 
050,孟加拉国,42,湖北省,2886672771 ,22259634 ,2908932405 
050,孟加拉国,43,湖南省,3015756135 ,71197279 ,3086953414 
050,孟加拉国,44,广东省,22878094002 ,750603124 ,23628697126 
050,孟加拉国,45,广西壮族自治区,585685478 ,26212882 ,611898360 
050,孟加拉国,46,海南省,553863305 ,12294378 ,566157683 
050,孟加拉国,50,重庆市,1345972815 ,2684084 ,1348656899 
050,孟加拉国,51,四川省,2199140188 ,52172841 ,2251313029 
050,孟加拉国,52,贵州省,259695380 ,0 ,259695380 
050,孟加拉国,53,云南省,2259525893 ,6091154 ,2265617047 
050,孟加拉国,54,西藏自治区,2160965 ,0 ,2160965 
050,孟加拉国,61,陕西省,914713346 ,1955914 ,916669260 
050,孟加拉国,62,甘肃省,117952676 ,0 ,117952676 
050,孟加拉国,63,青海省,22387065 ,291625 ,22678690 
050,孟加拉国,64,宁夏回族自治区,47494444 ,277 ,47494721 
050,孟加拉国,65,新疆维吾尔自治区,993606277 ,8709902 ,1002316179 
051,亚美尼亚,11,北京市,100450908 ,4392033 ,104842941 
051,亚美尼亚,12,天津市,9245613 ,70263 ,9315876 
051,亚美尼亚,13,河北省,41165709 ,0 ,41165709 
051,亚美尼亚,14,山西省,1337266 ,0 ,1337266 
051,亚美尼亚,15,内蒙古自治区,109752 ,0 ,109752 
051,亚美尼亚,21,辽宁省,12804057 ,416632624 ,429436681 
051,亚美尼亚,22,吉林省,311672 ,522 ,312194 
051,亚美尼亚,23,黑龙江省,3891303 ,1620973 ,5512276 
051,亚美尼亚,31,上海市,69095909 ,268259354 ,337355263 
051,亚美尼亚,32,江苏省,417767632 ,842964 ,418610596 
051,亚美尼亚,33,浙江省,463671038 ,108792456 ,572463494 
051,亚美尼亚,34,安徽省,36416050 ,395260133 ,431676183 
051,亚美尼亚,35,福建省,35535770 ,1007354 ,36543124 
051,亚美尼亚,36,江西省,18479084 ,568392641 ,586871725 
051,亚美尼亚,37,山东省,276106798 ,378484969 ,654591767 
051,亚美尼亚,41,河南省,72657988 ,0 ,72657988 
051,亚美尼亚,42,湖北省,25591099 ,385735 ,25976834 
051,亚美尼亚,43,湖南省,23347720 ,49576808 ,72924528 
051,亚美尼亚,44,广东省,415043085 ,78749322 ,493792407 
051,亚美尼亚,45,广西壮族自治区,11911932 ,711162345 ,723074277 
051,亚美尼亚,46,海南省,22270810 ,231543217 ,253814027 
051,亚美尼亚,50,重庆市,11861585 ,576897 ,12438482 
051,亚美尼亚,51,四川省,24869916 ,3030271 ,27900187 
051,亚美尼亚,52,贵州省,4397785 ,0 ,4397785 
051,亚美尼亚,53,云南省,3959796 ,1821978768 ,1825938564 
051,亚美尼亚,61,陕西省,32220079 ,29010 ,32249089 
051,亚美尼亚,62,甘肃省,531333 ,0 ,531333 
051,亚美尼亚,63,青海省,733934 ,0 ,733934 
051,亚美尼亚,64,宁夏回族自治区,27138 ,0 ,27138 
051,亚美尼亚,65,新疆维吾尔自治区,37180849 ,0 ,37180849 
052,巴巴多斯,11,北京市,78830091 ,74783 ,78904874 
052,巴巴多斯,12,天津市,64719347 ,0 ,64719347 
052,巴巴多斯,13,河北省,20192415 ,4264 ,20196679 
052,巴巴多斯,14,山西省,2805062 ,773 ,2805835 
052,巴巴多斯,21,辽宁省,5868130 ,0 ,5868130 
052,巴巴多斯,23,黑龙江省,10805 ,0 ,10805 
052,巴巴多斯,31,上海市,30423674 ,1967957 ,32391631 
052,巴巴多斯,32,江苏省,158519519 ,188828 ,158708347 
052,巴巴多斯,33,浙江省,208676700 ,200730 ,208877430 
052,巴巴多斯,34,安徽省,22162755 ,0 ,22162755 
052,巴巴多斯,35,福建省,21159472 ,17774 ,21177246 
052,巴巴多斯,36,江西省,23463321 ,0 ,23463321 
052,巴巴多斯,37,山东省,55643867 ,0 ,55643867 
052,巴巴多斯,41,河南省,2169089 ,0 ,2169089 
052,巴巴多斯,42,湖北省,3549398 ,0 ,3549398 
052,巴巴多斯,43,湖南省,4211921 ,871 ,4212792 
052,巴巴多斯,44,广东省,122626916 ,136716764 ,259343680 
052,巴巴多斯,45,广西壮族自治区,676413 ,0 ,676413 
052,巴巴多斯,50,重庆市,1132189 ,0 ,1132189 
052,巴巴多斯,51,四川省,2794335 ,180200 ,2974535 
052,巴巴多斯,52,贵州省,1371883 ,0 ,1371883 
052,巴巴多斯,53,云南省,2207038 ,0 ,2207038 
052,巴巴多斯,61,陕西省,1826155 ,0 ,1826155 
052,巴巴多斯,64,宁夏回族自治区,16119 ,0 ,16119 
052,巴巴多斯,65,新疆维吾尔自治区,3796779 ,0 ,3796779 
056,比利时,11,北京市,5506554862 ,5891457566 ,11398012428 
056,比利时,12,天津市,2474689578 ,497955347 ,2972644925 
056,比利时,13,河北省,3623058049 ,108733609 ,3731791658 
056,比利时,14,山西省,813666491 ,18544240 ,832210731 
056,比利时,15,内蒙古自治区,254612965 ,63366536 ,317979501 
056,比利时,21,辽宁省,2462733530 ,383221114 ,2845954644 
056,比利时,22,吉林省,1912588669 ,210564204 ,2123152873 
056,比利时,23,黑龙江省,1066316407 ,189646409 ,1255962816 
056,比利时,31,上海市,29334868476 ,9841119731 ,39175988207 
056,比利时,32,江苏省,25014454729 ,6019732551 ,31034187280 
056,比利时,33,浙江省,25828059154 ,2653199842 ,28481258996 
056,比利时,34,安徽省,2481052715 ,173865530 ,2654918245 
056,比利时,35,福建省,6898551993 ,720682078 ,7619234071 
056,比利时,36,江西省,2950742103 ,97728873 ,3048470976 
056,比利时,37,山东省,11935378645 ,941267978 ,12876646623 
056,比利时,41,河南省,3457902586 ,102206894 ,3560109480 
056,比利时,42,湖北省,3953854341 ,218930140 ,4172784481 
056,比利时,43,湖南省,2907089604 ,240827952 ,3147917556 
056,比利时,44,广东省,24044811418 ,14361641566 ,38406452984 
056,比利时,45,广西壮族自治区,1117455363 ,21255984 ,1138711347 
056,比利时,46,海南省,887102575 ,1048207649 ,1935310224 
056,比利时,50,重庆市,1419260081 ,119515604 ,1538775685 
056,比利时,51,四川省,4701810613 ,192103379 ,4893913992 
056,比利时,52,贵州省,397063931 ,6573301 ,403637232 
056,比利时,53,云南省,1030564194 ,83765000 ,1114329194 
056,比利时,54,西藏自治区,12132080 ,1671709 ,13803789 
056,比利时,61,陕西省,831130982 ,751988566 ,1583119548 
056,比利时,62,甘肃省,62088367 ,6565576 ,68653943 
056,比利时,63,青海省,1064210 ,10277155 ,11341365 
056,比利时,64,宁夏回族自治区,453721603 ,4732701 ,458454304 
056,比利时,65,新疆维吾尔自治区,673797526 ,4781506 ,678579032 
060,百慕大,11,北京市,9454801 ,640 ,9455441 
060,百慕大,12,天津市,163743557 ,0 ,163743557 
060,百慕大,13,河北省,16498 ,0 ,16498 
060,百慕大,21,辽宁省,136217 ,0 ,136217 
060,百慕大,31,上海市,67061563 ,3593 ,67065156 
060,百慕大,32,江苏省,116748114 ,167 ,116748281 
060,百慕大,33,浙江省,43454786 ,4918 ,43459704 
060,百慕大,34,安徽省,812084 ,0 ,812084 
060,百慕大,35,福建省,16962706 ,0 ,16962706 
060,百慕大,36,江西省,36542 ,0 ,36542 
060,百慕大,37,山东省,6355466 ,0 ,6355466 
060,百慕大,41,河南省,96372 ,0 ,96372 
060,百慕大,42,湖北省,41617 ,0 ,41617 
060,百慕大,43,湖南省,70300 ,0 ,70300 
060,百慕大,44,广东省,16959932 ,2030 ,16961962 
060,百慕大,51,四川省,122454 ,0 ,122454 
060,百慕大,52,贵州省,78 ,0 ,78 
060,百慕大,61,陕西省,86153 ,0 ,86153 
064,不丹,11,北京市,4937349 ,15333 ,4952682 
064,不丹,12,天津市,43691 ,180 ,43871 
064,不丹,13,河北省,317370 ,2952 ,320322 
064,不丹,14,山西省,1274548 ,0 ,1274548 
064,不丹,15,内蒙古自治区,1505 ,0 ,1505 
064,不丹,21,辽宁省,5148 ,0 ,5148 
064,不丹,22,吉林省,29222 ,0 ,29222 
064,不丹,31,上海市,1026057 ,16275 ,1042332 
064,不丹,32,江苏省,17936380 ,26 ,17936406 
064,不丹,33,浙江省,4771383 ,18118416 ,22889799 
064,不丹,34,安徽省,1275584 ,0 ,1275584 
064,不丹,35,福建省,7777514 ,154 ,7777668 
064,不丹,36,江西省,2524988 ,0 ,2524988 
064,不丹,37,山东省,7929646 ,3637 ,7933283 
064,不丹,41,河南省,895545 ,987 ,896532 
064,不丹,42,湖北省,1326943 ,0 ,1326943 
064,不丹,43,湖南省,216321852 ,0 ,216321852 
064,不丹,44,广东省,89282768 ,2775 ,89285543 
064,不丹,45,广西壮族自治区,2499131 ,0 ,2499131 
064,不丹,46,海南省,309234369 ,0 ,309234369 
064,不丹,50,重庆市,2180323 ,0 ,2180323 
064,不丹,51,四川省,754699 ,0 ,754699 
064,不丹,53,云南省,9188982 ,0 ,9188982 
064,不丹,54,西藏自治区,2744 ,0 ,2744 
064,不丹,61,陕西省,490908 ,0 ,490908 
068,多民族玻利维亚国,11,北京市,656535208 ,138796279 ,795331487 
068,多民族玻利维亚国,12,天津市,35476555 ,65145261 ,100621816 
068,多民族玻利维亚国,13,河北省,174864439 ,24618827 ,199483266 
068,多民族玻利维亚国,14,山西省,1827809 ,0 ,1827809 
068,多民族玻利维亚国,15,内蒙古自治区,3080839 ,0 ,3080839 
068,多民族玻利维亚国,21,辽宁省,45283327 ,7287083 ,52570410 
068,多民族玻利维亚国,22,吉林省,4854859 ,1215994 ,6070853 
068,多民族玻利维亚国,23,黑龙江省,9207679 ,0 ,9207679 
068,多民族玻利维亚国,31,上海市,297436722 ,111066400 ,408503122 
068,多民族玻利维亚国,32,江苏省,550176545 ,305273502 ,855450047 
068,多民族玻利维亚国,33,浙江省,759469473 ,234611931 ,994081404 
068,多民族玻利维亚国,34,安徽省,188997562 ,180378652 ,369376214 
068,多民族玻利维亚国,35,福建省,252971076 ,69286044 ,322257120 
068,多民族玻利维亚国,36,江西省,55323569 ,135940474 ,191264043 
068,多民族玻利维亚国,37,山东省,600397358 ,517207428 ,1117604786 
068,多民族玻利维亚国,41,河南省,93273879 ,1091532945 ,1184806824 
068,多民族玻利维亚国,42,湖北省,53723291 ,81072330 ,134795621 
068,多民族玻利维亚国,43,湖南省,58181549 ,319937613 ,378119162 
068,多民族玻利维亚国,44,广东省,801164254 ,307306948 ,1108471202 
068,多民族玻利维亚国,45,广西壮族自治区,64470749 ,50497640 ,114968389 
068,多民族玻利维亚国,46,海南省,129162 ,3000566 ,3129728 
068,多民族玻利维亚国,50,重庆市,219193534 ,17762862 ,236956396 
068,多民族玻利维亚国,51,四川省,56970560 ,14273969 ,71244529 
068,多民族玻利维亚国,52,贵州省,1750783 ,11471683 ,13222466 
068,多民族玻利维亚国,53,云南省,21388054 ,4768268 ,26156322 
068,多民族玻利维亚国,54,西藏自治区,311380 ,0 ,311380 
068,多民族玻利维亚国,61,陕西省,7378989 ,90691782 ,98070771 
068,多民族玻利维亚国,62,甘肃省,3398264 ,0 ,3398264 
068,多民族玻利维亚国,64,宁夏回族自治区,3409507 ,0 ,3409507 
068,多民族玻利维亚国,65,新疆维吾尔自治区,1249830 ,0 ,1249830 
070,波黑,11,北京市,38804159 ,9560335 ,48364494 
070,波黑,12,天津市,9941022 ,3220628 ,13161650 
070,波黑,13,河北省,4868147 ,204848 ,5072995 
070,波黑,14,山西省,92489 ,0 ,92489 
070,波黑,21,辽宁省,6325845 ,139496964 ,145822809 
070,波黑,22,吉林省,395713 ,1135281 ,1530994 
070,波黑,23,黑龙江省,5642293 ,188329 ,5830622 
070,波黑,31,上海市,33124654 ,193066103 ,226190757 
070,波黑,32,江苏省,98606843 ,34871009 ,133477852 
070,波黑,33,浙江省,190143985 ,62482109 ,252626094 
070,波黑,34,安徽省,20070063 ,5005116 ,25075179 
070,波黑,35,福建省,27246984 ,91887934 ,119134918 
070,波黑,36,江西省,7135909 ,1410462 ,8546371 
070,波黑,37,山东省,81160620 ,15536841 ,96697461 
070,波黑,41,河南省,12956916 ,2587 ,12959503 
070,波黑,42,湖北省,3364305 ,758900 ,4123205 
070,波黑,43,湖南省,8591434 ,208536 ,8799970 
070,波黑,44,广东省,168147049 ,60310380 ,228457429 
070,波黑,45,广西壮族自治区,1473440 ,41714552 ,43187992 
070,波黑,46,海南省,12102 ,10031449 ,10043551 
070,波黑,50,重庆市,15283139 ,2573214 ,17856353 
070,波黑,51,四川省,244911050 ,6166854 ,251077904 
070,波黑,52,贵州省,89951 ,0 ,89951 
070,波黑,53,云南省,1580573 ,10604521 ,12185094 
070,波黑,54,西藏自治区,274 ,0 ,274 
070,波黑,61,陕西省,2252611 ,140988 ,2393599 
070,波黑,64,宁夏回族自治区,13 ,0 ,13 
072,博茨瓦纳,11,北京市,53963227 ,40884097 ,94847324 
072,博茨瓦纳,12,天津市,3463675 ,0 ,3463675 
072,博茨瓦纳,13,河北省,12075404 ,0 ,12075404 
072,博茨瓦纳,14,山西省,822390 ,0 ,822390 
072,博茨瓦纳,15,内蒙古自治区,4107 ,0 ,4107 
072,博茨瓦纳,21,辽宁省,6086053 ,41 ,6086094 
072,博茨瓦纳,22,吉林省,7416 ,0 ,7416 
072,博茨瓦纳,23,黑龙江省,1962076 ,0 ,1962076 
072,博茨瓦纳,31,上海市,69838962 ,87854915 ,157693877 
072,博茨瓦纳,32,江苏省,92480080 ,4402891 ,96882971 
072,博茨瓦纳,33,浙江省,266253951 ,121447363 ,387701314 
072,博茨瓦纳,34,安徽省,14516288 ,0 ,14516288 
072,博茨瓦纳,35,福建省,28552600 ,222504380 ,251056980 
072,博茨瓦纳,36,江西省,29405453 ,0 ,29405453 
072,博茨瓦纳,37,山东省,114384968 ,22736573 ,137121541 
072,博茨瓦纳,41,河南省,6141922 ,0 ,6141922 
072,博茨瓦纳,42,湖北省,14077072 ,0 ,14077072 
072,博茨瓦纳,43,湖南省,55001380 ,0 ,55001380 
072,博茨瓦纳,44,广东省,282916729 ,203795986 ,486712715 
072,博茨瓦纳,45,广西壮族自治区,6909481 ,397195940 ,404105421 
072,博茨瓦纳,46,海南省,711354 ,0 ,711354 
072,博茨瓦纳,50,重庆市,3541357 ,0 ,3541357 
072,博茨瓦纳,51,四川省,9378377 ,593 ,9378970 
072,博茨瓦纳,52,贵州省,1401604 ,0 ,1401604 
072,博茨瓦纳,53,云南省,13161363 ,777573832 ,790735195 
072,博茨瓦纳,61,陕西省,6606653 ,0 ,6606653 
072,博茨瓦纳,62,甘肃省,529933 ,0 ,529933 
072,博茨瓦纳,64,宁夏回族自治区,14 ,0 ,14 
072,博茨瓦纳,65,新疆维吾尔自治区,4533187 ,0 ,4533187 
076,巴西,11,北京市,5034044282 ,92135450815 ,97169495097 
076,巴西,12,天津市,6840470571 ,15930505523 ,22770976094 
076,巴西,13,河北省,6246042458 ,28582650342 ,34828692800 
076,巴西,14,山西省,2672663813 ,1381893415 ,4054557228 
076,巴西,15,内蒙古自治区,874936243 ,77973940 ,952910183 
076,巴西,21,辽宁省,2425528878 ,19034588394 ,21460117272 
076,巴西,22,吉林省,235856147 ,4388245290 ,4624101437 
076,巴西,23,黑龙江省,464616535 ,6280258417 ,6744874952 
076,巴西,31,上海市,15862644128 ,59620837808 ,75483481936 
076,巴西,32,江苏省,57862507474 ,74760394372 ,132622901846 
076,巴西,33,浙江省,65820297219 ,32971601299 ,98791898518 
076,巴西,34,安徽省,12695762951 ,7738251728 ,20434014679 
076,巴西,35,福建省,10733895768 ,33316376731 ,44050272499 
076,巴西,36,江西省,8427493508 ,3819530327 ,12247023835 
076,巴西,37,山东省,26411234824 ,83344439995 ,109755674819 
076,巴西,41,河南省,5410020208 ,3366704673 ,8776724881 
076,巴西,42,湖北省,16844722896 ,6166573280 ,23011296176 
076,巴西,43,湖南省,4845476024 ,11131907939 ,15977383963 
076,巴西,44,广东省,42245526605 ,33170246500 ,75415773105 
076,巴西,45,广西壮族自治区,1267489279 ,20617048497 ,21884537776 
076,巴西,46,海南省,499518523 ,2054742512 ,2554261035 
076,巴西,50,重庆市,4188200251 ,4922365004 ,9110565255 
076,巴西,51,四川省,7262110960 ,3460606033 ,10722716993 
076,巴西,52,贵州省,455009597 ,215963353 ,670972950 
076,巴西,53,云南省,3397256013 ,4918826959 ,8316082972 
076,巴西,54,西藏自治区,21066558 ,0 ,21066558 
076,巴西,61,陕西省,3724752728 ,5061266725 ,8786019453 
076,巴西,62,甘肃省,194290216 ,809020172 ,1003310388 
076,巴西,63,青海省,12973403 ,2519768 ,15493171 
076,巴西,64,宁夏回族自治区,773716822 ,47556143 ,821272965 
076,巴西,65,新疆维吾尔自治区,818509986 ,110932450 ,929442436 
084,伯利兹,11,北京市,17073148 ,4295 ,17077443 
084,伯利兹,12,天津市,15467815 ,0 ,15467815 
084,伯利兹,13,河北省,16537537 ,0 ,16537537 
084,伯利兹,14,山西省,629756 ,0 ,629756 
084,伯利兹,21,辽宁省,8031243 ,0 ,8031243 
084,伯利兹,23,黑龙江省,331637 ,0 ,331637 
084,伯利兹,31,上海市,29455769 ,87879 ,29543648 
084,伯利兹,32,江苏省,71743103 ,522658 ,72265761 
084,伯利兹,33,浙江省,611422143 ,0 ,611422143 
084,伯利兹,34,安徽省,9260644 ,0 ,9260644 
084,伯利兹,35,福建省,36615741 ,0 ,36615741 
084,伯利兹,36,江西省,35175656 ,0 ,35175656 
084,伯利兹,37,山东省,506589286 ,0 ,506589286 
084,伯利兹,41,河南省,9666027 ,0 ,9666027 
084,伯利兹,42,湖北省,28069500 ,0 ,28069500 
084,伯利兹,43,湖南省,62723352 ,0 ,62723352 
084,伯利兹,44,广东省,140126129 ,109999 ,140236128 
084,伯利兹,45,广西壮族自治区,10488582 ,0 ,10488582 
084,伯利兹,46,海南省,40718 ,0 ,40718 
084,伯利兹,50,重庆市,27392024 ,0 ,27392024 
084,伯利兹,51,四川省,23429633 ,0 ,23429633 
084,伯利兹,52,贵州省,2988427 ,0 ,2988427 
084,伯利兹,53,云南省,673166 ,0 ,673166 
084,伯利兹,61,陕西省,67982 ,0 ,67982 
090,所罗门群岛,11,北京市,135832696 ,468340097 ,604172793 
090,所罗门群岛,12,天津市,6328863 ,0 ,6328863 
090,所罗门群岛,13,河北省,24716026 ,0 ,24716026 
090,所罗门群岛,15,内蒙古自治区,1205835 ,0 ,1205835 
090,所罗门群岛,21,辽宁省,619425 ,398 ,619823 
090,所罗门群岛,22,吉林省,356850 ,0 ,356850 
090,所罗门群岛,23,黑龙江省,182950 ,0 ,182950 
090,所罗门群岛,31,上海市,23531926 ,198745624 ,222277550 
090,所罗门群岛,32,江苏省,80954007 ,316332471 ,397286478 
090,所罗门群岛,33,浙江省,116255699 ,78037624 ,194293323 
090,所罗门群岛,34,安徽省,6736453 ,0 ,6736453 
090,所罗门群岛,35,福建省,39425664 ,82887807 ,122313471 
090,所罗门群岛,36,江西省,64247675 ,3210367 ,67458042 
090,所罗门群岛,37,山东省,99521922 ,54156333 ,153678255 
090,所罗门群岛,41,河南省,1786896 ,0 ,1786896 
090,所罗门群岛,42,湖北省,18482153 ,0 ,18482153 
090,所罗门群岛,43,湖南省,48605134 ,0 ,48605134 
090,所罗门群岛,44,广东省,161920209 ,348806497 ,510726706 
090,所罗门群岛,45,广西壮族自治区,11404295 ,0 ,11404295 
090,所罗门群岛,50,重庆市,13414807 ,0 ,13414807 
090,所罗门群岛,51,四川省,37101585 ,132 ,37101717 
090,所罗门群岛,52,贵州省,3108255 ,0 ,3108255 
090,所罗门群岛,53,云南省,8977489 ,0 ,8977489 
090,所罗门群岛,61,陕西省,2929162 ,0 ,2929162 
090,所罗门群岛,65,新疆维吾尔自治区,1603896 ,0 ,1603896 
092,英属维尔京群岛,11,北京市,9145792 ,2235 ,9148027 
092,英属维尔京群岛,12,天津市,2481721 ,0 ,2481721 
092,英属维尔京群岛,13,河北省,3205174 ,0 ,3205174 
092,英属维尔京群岛,21,辽宁省,1378568 ,0 ,1378568 
092,英属维尔京群岛,31,上海市,77379107 ,836 ,77379943 
092,英属维尔京群岛,32,江苏省,530947437 ,95826 ,531043263 
092,英属维尔京群岛,33,浙江省,6913659 ,3483 ,6917142 
092,英属维尔京群岛,34,安徽省,204845 ,0 ,204845 
092,英属维尔京群岛,35,福建省,3386677 ,0 ,3386677 
092,英属维尔京群岛,36,江西省,2887769 ,0 ,2887769 
092,英属维尔京群岛,37,山东省,8919775 ,2153 ,8921928 
092,英属维尔京群岛,41,河南省,162038 ,177430 ,339468 
092,英属维尔京群岛,42,湖北省,3828161 ,6398 ,3834559 
092,英属维尔京群岛,43,湖南省,1922019 ,0 ,1922019 
092,英属维尔京群岛,44,广东省,15414282 ,1095 ,15415377 
092,英属维尔京群岛,50,重庆市,957798 ,0 ,957798 
092,英属维尔京群岛,51,四川省,2580019 ,480 ,2580499 
092,英属维尔京群岛,53,云南省,3492845 ,0 ,3492845 
092,英属维尔京群岛,64,宁夏回族自治区,178094 ,0 ,178094 
096,文莱,11,北京市,1092140261 ,248694547 ,1340834808 
096,文莱,12,天津市,27420087 ,25303745 ,52723832 
096,文莱,13,河北省,63492998 ,0 ,63492998 
096,文莱,14,山西省,6925665 ,0 ,6925665 
096,文莱,15,内蒙古自治区,1817901 ,0 ,1817901 
096,文莱,21,辽宁省,21129498 ,343870404 ,364999902 
096,文莱,22,吉林省,213845 ,0 ,213845 
096,文莱,23,黑龙江省,6487273 ,0 ,6487273 
096,文莱,31,上海市,132985392 ,23212816 ,156198208 
096,文莱,32,江苏省,221498085 ,840279490 ,1061777575 
096,文莱,33,浙江省,373865811 ,6076708588 ,6450574399 
096,文莱,34,安徽省,41448882 ,1669034 ,43117916 
096,文莱,35,福建省,203999864 ,24831663 ,228831527 
096,文莱,36,江西省,169670384 ,0 ,169670384 
096,文莱,37,山东省,363256582 ,62240650 ,425497232 
096,文莱,41,河南省,18877269 ,110976 ,18988245 
096,文莱,42,湖北省,66355816 ,1348 ,66357164 
096,文莱,43,湖南省,143921797 ,0 ,143921797 
096,文莱,44,广东省,525426730 ,1812176534 ,2337603264 
096,文莱,45,广西壮族自治区,19434187 ,28015622 ,47449809 
096,文莱,46,海南省,298245 ,1654218083 ,1654516328 
096,文莱,50,重庆市,23292301 ,0 ,23292301 
096,文莱,51,四川省,66145155 ,231835 ,66376990 
096,文莱,52,贵州省,7630929 ,0 ,7630929 
096,文莱,53,云南省,54085159 ,0 ,54085159 
096,文莱,61,陕西省,20060989 ,0 ,20060989 
096,文莱,62,甘肃省,670176 ,0 ,670176 
096,文莱,64,宁夏回族自治区,927367 ,0 ,927367 
096,文莱,65,新疆维吾尔自治区,11038405 ,0 ,11038405 
100,保加利亚,11,北京市,518389389 ,426321979 ,944711368 
100,保加利亚,12,天津市,227368227 ,45379931 ,272748158 
100,保加利亚,13,河北省,189463031 ,28543225 ,218006256 
100,保加利亚,14,山西省,7435227 ,78291 ,7513518 
100,保加利亚,15,内蒙古自治区,18100700 ,268801114 ,286901814 
100,保加利亚,21,辽宁省,144941589 ,421791821 ,566733410 
100,保加利亚,22,吉林省,23619624 ,161440192 ,185059816 
100,保加利亚,23,黑龙江省,16297472 ,17051218 ,33348690 
100,保加利亚,31,上海市,863783361 ,1451827484 ,2315610845 
100,保加利亚,32,江苏省,2311882058 ,582558194 ,2894440252 
100,保加利亚,33,浙江省,3850974616 ,511083903 ,4362058519 
100,保加利亚,34,安徽省,787817805 ,39833785 ,827651590 
100,保加利亚,35,福建省,503576542 ,1047171709 ,1550748251 
100,保加利亚,36,江西省,180857406 ,1497851 ,182355257 
100,保加利亚,37,山东省,944314330 ,774663056 ,1718977386 
100,保加利亚,41,河南省,168919072 ,39719476 ,208638548 
100,保加利亚,42,湖北省,194040337 ,26464907 ,220505244 
100,保加利亚,43,湖南省,187718297 ,33552465 ,221270762 
100,保加利亚,44,广东省,2700773111 ,233793886 ,2934566997 
100,保加利亚,45,广西壮族自治区,33089234 ,16909760 ,49998994 
100,保加利亚,46,海南省,16142699 ,24538053 ,40680752 
100,保加利亚,50,重庆市,107624676 ,10205685 ,117830361 
100,保加利亚,51,四川省,188351045 ,31883710 ,220234755 
100,保加利亚,52,贵州省,29337335 ,0 ,29337335 
100,保加利亚,53,云南省,24766125 ,49344430 ,74110555 
100,保加利亚,54,西藏自治区,241835 ,0 ,241835 
100,保加利亚,61,陕西省,118023143 ,76606107 ,194629250 
100,保加利亚,62,甘肃省,2160688 ,38771856 ,40932544 
100,保加利亚,63,青海省,78 ,0 ,78 
100,保加利亚,64,宁夏回族自治区,2431572 ,29915 ,2461487 
100,保加利亚,65,新疆维吾尔自治区,4179839 ,8353890 ,12533729 
104,缅甸,11,北京市,1739268577 ,2091098940 ,3830367517 
104,缅甸,12,天津市,707951148 ,627064489 ,1335015637 
104,缅甸,13,河北省,1195992060 ,317192466 ,1513184526 
104,缅甸,14,山西省,47119459 ,1670374 ,48789833 
104,缅甸,15,内蒙古自治区,306656295 ,1459779 ,308116074 
104,缅甸,21,辽宁省,1670038039 ,188143788 ,1858181827 
104,缅甸,22,吉林省,53312898 ,11951063 ,65263961 
104,缅甸,23,黑龙江省,225434362 ,59444208 ,284878570 
104,缅甸,31,上海市,2416699048 ,730799698 ,3147498746 
104,缅甸,32,江苏省,9083347108 ,356310305 ,9439657413 
104,缅甸,33,浙江省,9529274626 ,507045175 ,10036319801 
104,缅甸,34,安徽省,1628974069 ,880351378 ,2509325447 
104,缅甸,35,福建省,3606503431 ,377496991 ,3984000422 
104,缅甸,36,江西省,2244375254 ,128402927 ,2372778181 
104,缅甸,37,山东省,8348254691 ,2848092057 ,11196346748 
104,缅甸,41,河南省,458152790 ,1546492774 ,2004645564 
104,缅甸,42,湖北省,1789176420 ,33971076 ,1823147496 
104,缅甸,43,湖南省,2142532348 ,275339754 ,2417872102 
104,缅甸,44,广东省,7493530813 ,11843049886 ,19336580699 
104,缅甸,45,广西壮族自治区,456023477 ,214398982 ,670422459 
104,缅甸,46,海南省,197499795 ,38068056 ,235567851 
104,缅甸,50,重庆市,926316643 ,43170377 ,969487020 
104,缅甸,51,四川省,1038875812 ,43426171 ,1082301983 
104,缅甸,52,贵州省,171794419 ,803985 ,172598404 
104,缅甸,53,云南省,10319192646 ,24023699100 ,34342891746 
104,缅甸,54,西藏自治区,402074 ,0 ,402074 
104,缅甸,61,陕西省,193350811 ,136526244 ,329877055 
104,缅甸,62,甘肃省,19852164 ,6017804 ,25869968 
104,缅甸,63,青海省,7874964 ,0 ,7874964 
104,缅甸,64,宁夏回族自治区,51924759 ,797 ,51925556 
104,缅甸,65,新疆维吾尔自治区,134037980 ,96994754 ,231032734 
108,布隆迪,11,北京市,32898307 ,8564 ,32906871 
108,布隆迪,12,天津市,11973997 ,463344 ,12437341 
108,布隆迪,13,河北省,11334633 ,0 ,11334633 
108,布隆迪,14,山西省,68023 ,0 ,68023 
108,布隆迪,15,内蒙古自治区,231077 ,0 ,231077 
108,布隆迪,21,辽宁省,1649037 ,0 ,1649037 
108,布隆迪,22,吉林省,219947 ,0 ,219947 
108,布隆迪,23,黑龙江省,2367564 ,0 ,2367564 
108,布隆迪,31,上海市,17519522 ,45394 ,17564916 
108,布隆迪,32,江苏省,90282436 ,60082 ,90342518 
108,布隆迪,33,浙江省,45568248 ,9724588 ,55292836 
108,布隆迪,34,安徽省,16068804 ,659 ,16069463 
108,布隆迪,35,福建省,33396472 ,14704142 ,48100614 
108,布隆迪,36,江西省,20863541 ,5566749 ,26430290 
108,布隆迪,37,山东省,82304212 ,0 ,82304212 
108,布隆迪,41,河南省,13909355 ,0 ,13909355 
108,布隆迪,42,湖北省,9517077 ,0 ,9517077 
108,布隆迪,43,湖南省,33111209 ,0 ,33111209 
108,布隆迪,44,广东省,97305283 ,12071541 ,109376824 
108,布隆迪,45,广西壮族自治区,4925125 ,0 ,4925125 
108,布隆迪,46,海南省,145055 ,0 ,145055 
108,布隆迪,50,重庆市,31348791 ,0 ,31348791 
108,布隆迪,51,四川省,16777152 ,648 ,16777800 
108,布隆迪,52,贵州省,39 ,0 ,39 
108,布隆迪,53,云南省,6366329 ,0 ,6366329 
108,布隆迪,61,陕西省,1020525 ,0 ,1020525 
108,布隆迪,64,宁夏回族自治区,957803 ,0 ,957803 
112,白俄罗斯,11,北京市,543353155 ,3699989373 ,4243342528 
112,白俄罗斯,12,天津市,93336382 ,110383607 ,203719989 
112,白俄罗斯,13,河北省,141175148 ,8831206 ,150006354 
112,白俄罗斯,14,山西省,3995769 ,7671885 ,11667654 
112,白俄罗斯,15,内蒙古自治区,14404886 ,31149898 ,45554784 
112,白俄罗斯,21,辽宁省,174687478 ,1058748970 ,1233436448 
112,白俄罗斯,22,吉林省,9066740 ,4107340 ,13174080 
112,白俄罗斯,23,黑龙江省,37285612 ,105006690 ,142292302 
112,白俄罗斯,31,上海市,306571015 ,235673906 ,542244921 
112,白俄罗斯,32,江苏省,891402330 ,798819051 ,1690221381 
112,白俄罗斯,33,浙江省,3720961563 ,343782564 ,4064744127 
112,白俄罗斯,34,安徽省,177281781 ,77189295 ,254471076 
112,白俄罗斯,35,福建省,312995369 ,270270269 ,583265638 
112,白俄罗斯,36,江西省,184443572 ,1323631 ,185767203 
112,白俄罗斯,37,山东省,1569128869 ,307764605 ,1876893474 
112,白俄罗斯,41,河南省,277059303 ,135672196 ,412731499 
112,白俄罗斯,42,湖北省,57237595 ,382327404 ,439564999 
112,白俄罗斯,43,湖南省,1094846724 ,22419643 ,1117266367 
112,白俄罗斯,44,广东省,2497049818 ,1115131194 ,3612181012 
112,白俄罗斯,45,广西壮族自治区,11105820 ,46814592 ,57920412 
112,白俄罗斯,46,海南省,10163405 ,14247927 ,24411332 
112,白俄罗斯,50,重庆市,207571017 ,154513415 ,362084432 
112,白俄罗斯,51,四川省,1423690857 ,141594677 ,1565285534 
112,白俄罗斯,52,贵州省,3948806 ,171514 ,4120320 
112,白俄罗斯,53,云南省,12297263 ,2503353 ,14800616 
112,白俄罗斯,61,陕西省,283396322 ,27283842 ,310680164 
112,白俄罗斯,62,甘肃省,14726920 ,56169 ,14783089 
112,白俄罗斯,63,青海省,0 ,997860 ,997860 
112,白俄罗斯,64,宁夏回族自治区,11547565 ,0 ,11547565 
112,白俄罗斯,65,新疆维吾尔自治区,55856203 ,17246456 ,73102659 
116,柬埔寨,11,北京市,1630409434 ,1506657017 ,3137066451 
116,柬埔寨,12,天津市,492154810 ,372496543 ,864651353 
116,柬埔寨,13,河北省,818393774 ,192593640 ,1010987414 
116,柬埔寨,14,山西省,36164191 ,1559385 ,37723576 
116,柬埔寨,15,内蒙古自治区,132981408 ,3455 ,132984863 
116,柬埔寨,21,辽宁省,420359295 ,455878956 ,876238251 
116,柬埔寨,22,吉林省,87919084 ,4211 ,87923295 
116,柬埔寨,23,黑龙江省,40788522 ,13788429 ,54576951 
116,柬埔寨,31,上海市,2800319337 ,2281794777 ,5082114114 
116,柬埔寨,32,江苏省,11989739367 ,921029363 ,12910768730 
116,柬埔寨,33,浙江省,12046473618 ,731351538 ,12777825156 
116,柬埔寨,34,安徽省,876499051 ,39052311 ,915551362 
116,柬埔寨,35,福建省,4250732628 ,545315002 ,4796047630 
116,柬埔寨,36,江西省,2751691523 ,92918055 ,2844609578 
116,柬埔寨,37,山东省,6506353101 ,408978650 ,6915331751 
116,柬埔寨,41,河南省,762754975 ,11560918 ,774315893 
116,柬埔寨,42,湖北省,1156948535 ,13555996 ,1170504531 
116,柬埔寨,43,湖南省,2052386034 ,60795056 ,2113181090 
116,柬埔寨,44,广东省,16128122190 ,1049922049 ,17178044239 
116,柬埔寨,45,广西壮族自治区,1017976685 ,89009113 ,1106985798 
116,柬埔寨,46,海南省,179434693 ,50694394 ,230129087 
116,柬埔寨,50,重庆市,1062997626 ,1500308 ,1064497934 
116,柬埔寨,51,四川省,979839313 ,109715180 ,1089554493 
116,柬埔寨,52,贵州省,123305279 ,0 ,123305279 
116,柬埔寨,53,云南省,809850331 ,440626 ,810290957 
116,柬埔寨,54,西藏自治区,13 ,0 ,13 
116,柬埔寨,61,陕西省,708257940 ,10196503 ,718454443 
116,柬埔寨,62,甘肃省,24867853 ,5396324 ,30264177 
116,柬埔寨,63,青海省,4254762 ,0 ,4254762 
116,柬埔寨,64,宁夏回族自治区,29872374 ,0 ,29872374 
116,柬埔寨,65,新疆维吾尔自治区,100714695 ,44152604 ,144867299 
120,喀麦隆,11,北京市,360594703 ,1758846558 ,2119441261 
120,喀麦隆,12,天津市,247960778 ,195110 ,248155888 
120,喀麦隆,13,河北省,286071187 ,781663 ,286852850 
120,喀麦隆,14,山西省,25976811 ,0 ,25976811 
120,喀麦隆,15,内蒙古自治区,57328626 ,0 ,57328626 
120,喀麦隆,21,辽宁省,111843357 ,4504 ,111847861 
120,喀麦隆,22,吉林省,4802188 ,0 ,4802188 
120,喀麦隆,23,黑龙江省,16651254 ,0 ,16651254 
120,喀麦隆,31,上海市,597119990 ,223401110 ,820521100 
120,喀麦隆,32,江苏省,780233428 ,657062105 ,1437295533 
120,喀麦隆,33,浙江省,4644632652 ,261484885 ,4906117537 
120,喀麦隆,34,安徽省,322066635 ,10143486 ,332210121 
120,喀麦隆,35,福建省,880448554 ,66966935 ,947415489 
120,喀麦隆,36,江西省,476787252 ,0 ,476787252 
120,喀麦隆,37,山东省,1793776328 ,122144799 ,1915921127 
120,喀麦隆,41,河南省,129813095 ,10861 ,129823956 
120,喀麦隆,42,湖北省,310528078 ,29021332 ,339549410 
120,喀麦隆,43,湖南省,454962020 ,514007 ,455476027 
120,喀麦隆,44,广东省,2417598124 ,702685104 ,3120283228 
120,喀麦隆,45,广西壮族自治区,91242969 ,0 ,91242969 
120,喀麦隆,46,海南省,20128547 ,0 ,20128547 
120,喀麦隆,50,重庆市,200624228 ,0 ,200624228 
120,喀麦隆,51,四川省,261320474 ,224224 ,261544698 
120,喀麦隆,52,贵州省,19073965 ,0 ,19073965 
120,喀麦隆,53,云南省,153340335 ,0 ,153340335 
120,喀麦隆,54,西藏自治区,1672083 ,0 ,1672083 
120,喀麦隆,61,陕西省,182956834 ,452143 ,183408977 
120,喀麦隆,62,甘肃省,3596698 ,0 ,3596698 
120,喀麦隆,63,青海省,1440212 ,0 ,1440212 
120,喀麦隆,64,宁夏回族自治区,3662005 ,0 ,3662005 
120,喀麦隆,65,新疆维吾尔自治区,50087151 ,261 ,50087412 
124,加拿大,11,北京市,2194435693 ,65977391698 ,68171827391 
124,加拿大,12,天津市,4308980965 ,1816896886 ,6125877851 
124,加拿大,13,河北省,3910334675 ,1474954090 ,5385288765 
124,加拿大,14,山西省,2488653389 ,573288404 ,3061941793 
124,加拿大,15,内蒙古自治区,306924727 ,81883137 ,388807864 
124,加拿大,21,辽宁省,3522140077 ,2754589414 ,6276729491 
124,加拿大,22,吉林省,401593657 ,76288609 ,477882266 
124,加拿大,23,黑龙江省,626634101 ,426465682 ,1053099783 
124,加拿大,31,上海市,16262292286 ,22374968967 ,38637261253 
124,加拿大,32,江苏省,40446847989 ,10850336054 ,51297184043 
124,加拿大,33,浙江省,49720508920 ,9605244704 ,59325753624 
124,加拿大,34,安徽省,6157673210 ,4001599555 ,10159272765 
124,加拿大,35,福建省,12897416972 ,15830346204 ,28727763176 
124,加拿大,36,江西省,4943594039 ,819425664 ,5763019703 
124,加拿大,37,山东省,33703731373 ,11387539904 ,45091271277 
124,加拿大,41,河南省,6837283024 ,950885210 ,7788168234 
124,加拿大,42,湖北省,3272027697 ,956382833 ,4228410530 
124,加拿大,43,湖南省,5622314064 ,2086958465 ,7709272529 
124,加拿大,44,广东省,61254536270 ,14639792867 ,75894329137 
124,加拿大,45,广西壮族自治区,1554626422 ,7657991400 ,9212617822 
124,加拿大,46,海南省,386663490 ,2052566974 ,2439230464 
124,加拿大,50,重庆市,6029150637 ,573585472 ,6602736109 
124,加拿大,51,四川省,4275999720 ,839031107 ,5115030827 
124,加拿大,52,贵州省,324215255 ,340365431 ,664580686 
124,加拿大,53,云南省,1503071785 ,661394200 ,2164465985 
124,加拿大,54,西藏自治区,33709615 ,0 ,33709615 
124,加拿大,61,陕西省,641959238 ,491930837 ,1133890075 
124,加拿大,62,甘肃省,93812912 ,117120733 ,210933645 
124,加拿大,63,青海省,33753142 ,1255494 ,35008636 
124,加拿大,64,宁夏回族自治区,200914861 ,690615 ,201605476 
124,加拿大,65,新疆维吾尔自治区,222768178 ,114716948 ,337485126 
132,佛得角,11,北京市,1963229 ,8222 ,1971451 
132,佛得角,12,天津市,413905 ,0 ,413905 
132,佛得角,13,河北省,11759118 ,0 ,11759118 
132,佛得角,14,山西省,220315 ,0 ,220315 
132,佛得角,21,辽宁省,1000032 ,0 ,1000032 
132,佛得角,22,吉林省,39 ,0 ,39 
132,佛得角,23,黑龙江省,1278123 ,0 ,1278123 
132,佛得角,31,上海市,1321520 ,48439 ,1369959 
132,佛得角,32,江苏省,21188994 ,31572 ,21220566 
132,佛得角,33,浙江省,187030772 ,0 ,187030772 
132,佛得角,34,安徽省,19541847 ,0 ,19541847 
132,佛得角,35,福建省,14783775 ,0 ,14783775 
132,佛得角,36,江西省,18549229 ,0 ,18549229 
132,佛得角,37,山东省,84254498 ,0 ,84254498 
132,佛得角,41,河南省,3408194 ,0 ,3408194 
132,佛得角,42,湖北省,7019716 ,0 ,7019716 
132,佛得角,43,湖南省,15173957 ,0 ,15173957 
132,佛得角,44,广东省,38634467 ,26655 ,38661122 
132,佛得角,45,广西壮族自治区,894764 ,0 ,894764 
132,佛得角,46,海南省,102547 ,0 ,102547 
132,佛得角,50,重庆市,1310657 ,0 ,1310657 
132,佛得角,51,四川省,1316774 ,0 ,1316774 
132,佛得角,53,云南省,7425755 ,0 ,7425755 
132,佛得角,61,陕西省,3075386 ,0 ,3075386 
136,开曼群岛,11,北京市,2538273 ,33478 ,2571751 
136,开曼群岛,12,天津市,1586446 ,0 ,1586446 
136,开曼群岛,13,河北省,667801 ,0 ,667801 
136,开曼群岛,15,内蒙古自治区,2873 ,0 ,2873 
136,开曼群岛,21,辽宁省,851278 ,0 ,851278 
136,开曼群岛,23,黑龙江省,33232 ,1318 ,34550 
136,开曼群岛,31,上海市,17547300 ,11454 ,17558754 
136,开曼群岛,32,江苏省,13888248 ,0 ,13888248 
136,开曼群岛,33,浙江省,92484447 ,14853 ,92499300 
136,开曼群岛,34,安徽省,1479614 ,0 ,1479614 
136,开曼群岛,35,福建省,14044556 ,0 ,14044556 
136,开曼群岛,36,江西省,4871993 ,0 ,4871993 
136,开曼群岛,37,山东省,14913896 ,0 ,14913896 
136,开曼群岛,41,河南省,862134 ,0 ,862134 
136,开曼群岛,42,湖北省,5714148 ,0 ,5714148 
136,开曼群岛,43,湖南省,4797174 ,0 ,4797174 
136,开曼群岛,44,广东省,30944347 ,21279 ,30965626 
136,开曼群岛,45,广西壮族自治区,6691654 ,0 ,6691654 
136,开曼群岛,50,重庆市,11358746 ,0 ,11358746 
136,开曼群岛,51,四川省,891652 ,0 ,891652 
140,中非,11,北京市,6374372 ,27134602 ,33508974 
140,中非,12,天津市,16814021 ,13838 ,16827859 
140,中非,13,河北省,4233229 ,0 ,4233229 
140,中非,14,山西省,59783229 ,0 ,59783229 
140,中非,21,辽宁省,7882 ,0 ,7882 
140,中非,23,黑龙江省,1322393 ,0 ,1322393 
140,中非,31,上海市,35291811 ,5378011 ,40669822 
140,中非,32,江苏省,10514833 ,72045218 ,82560051 
140,中非,33,浙江省,9306200 ,4424673 ,13730873 
140,中非,34,安徽省,3393714 ,0 ,3393714 
140,中非,35,福建省,3017605 ,5478650 ,8496255 
140,中非,36,江西省,1849584 ,0 ,1849584 
140,中非,37,山东省,22238619 ,331992 ,22570611 
140,中非,41,河南省,6611705 ,0 ,6611705 
140,中非,42,湖北省,859371 ,1213 ,860584 
140,中非,43,湖南省,8518981 ,0 ,8518981 
140,中非,44,广东省,38387291 ,7957745 ,46345036 
140,中非,45,广西壮族自治区,891593 ,0 ,891593 
140,中非,46,海南省,13576764 ,0 ,13576764 
140,中非,50,重庆市,15533537 ,0 ,15533537 
140,中非,51,四川省,39 ,579 ,618 
144,斯里兰卡,11,北京市,455599466 ,188202144 ,643801610 
144,斯里兰卡,12,天津市,514578268 ,14016131 ,528594399 
144,斯里兰卡,13,河北省,447563135 ,12984676 ,460547811 
144,斯里兰卡,14,山西省,33849904 ,45753 ,33895657 
144,斯里兰卡,15,内蒙古自治区,36478963 ,1961 ,36480924 
144,斯里兰卡,21,辽宁省,108350438 ,15049848 ,123400286 
144,斯里兰卡,22,吉林省,17592492 ,15828 ,17608320 
144,斯里兰卡,23,黑龙江省,41880458 ,288218 ,42168676 
144,斯里兰卡,31,上海市,996278995 ,786978389 ,1783257384 
144,斯里兰卡,32,江苏省,2243679938 ,241530402 ,2485210340 
144,斯里兰卡,33,浙江省,4197283634 ,83034248 ,4280317882 
144,斯里兰卡,34,安徽省,309574190 ,18305797 ,327879987 
144,斯里兰卡,35,福建省,1189377033 ,161677580 ,1351054613 
144,斯里兰卡,36,江西省,509049097 ,8593679 ,517642776 
144,斯里兰卡,37,山东省,1924892116 ,44874483 ,1969766599 
144,斯里兰卡,41,河南省,161228336 ,340282 ,161568618 
144,斯里兰卡,42,湖北省,374066069 ,143314 ,374209383 
144,斯里兰卡,43,湖南省,540072748 ,1685987 ,541758735 
144,斯里兰卡,44,广东省,3695822335 ,1001552020 ,4697374355 
144,斯里兰卡,45,广西壮族自治区,55793460 ,6874869 ,62668329 
144,斯里兰卡,46,海南省,17557794 ,3169512 ,20727306 
144,斯里兰卡,50,重庆市,153579384 ,184052 ,153763436 
144,斯里兰卡,51,四川省,259659526 ,1862727 ,261522253 
144,斯里兰卡,52,贵州省,21844709 ,830819 ,22675528 
144,斯里兰卡,53,云南省,89138967 ,22566123 ,111705090 
144,斯里兰卡,54,西藏自治区,1484756 ,0 ,1484756 
144,斯里兰卡,61,陕西省,28335962 ,3964485 ,32300447 
144,斯里兰卡,62,甘肃省,1409318 ,922975 ,2332293 
144,斯里兰卡,63,青海省,126738 ,0 ,126738 
144,斯里兰卡,64,宁夏回族自治区,26533969 ,0 ,26533969 
144,斯里兰卡,65,新疆维吾尔自治区,22921273 ,0 ,22921273 
148,乍得,11,北京市,365833074 ,5741501629 ,6107334703 
148,乍得,12,天津市,33266581 ,7472 ,33274053 
148,乍得,13,河北省,103985789 ,640 ,103986429 
148,乍得,14,山西省,514370 ,0 ,514370 
148,乍得,21,辽宁省,5014477 ,0 ,5014477 
148,乍得,23,黑龙江省,54921298 ,0 ,54921298 
148,乍得,31,上海市,5947397 ,7583 ,5954980 
148,乍得,32,江苏省,111208034 ,2354 ,111210388 
148,乍得,33,浙江省,207504300 ,903 ,207505203 
148,乍得,34,安徽省,18388376 ,4941474 ,23329850 
148,乍得,35,福建省,15069070 ,134 ,15069204 
148,乍得,36,江西省,10239956 ,0 ,10239956 
148,乍得,37,山东省,83551232 ,690241657 ,773792889 
148,乍得,41,河南省,17003134 ,0 ,17003134 
148,乍得,42,湖北省,15278115 ,1641 ,15279756 
148,乍得,43,湖南省,34363891 ,0 ,34363891 
148,乍得,44,广东省,170793177 ,53514 ,170846691 
148,乍得,45,广西壮族自治区,13922582 ,0 ,13922582 
148,乍得,50,重庆市,63250157 ,0 ,63250157 
148,乍得,51,四川省,6934985 ,8333 ,6943318 
148,乍得,52,贵州省,512987 ,0 ,512987 
148,乍得,53,云南省,425 ,0 ,425 
148,乍得,61,陕西省,1760456 ,0 ,1760456 
148,乍得,62,甘肃省,23095 ,0 ,23095 
148,乍得,65,新疆维吾尔自治区,12032333 ,0 ,12032333 
152,智利,11,北京市,3080928402 ,5021788366 ,8102716768 
152,智利,12,天津市,1473065738 ,1622310844 ,3095376582 
152,智利,13,河北省,2458920197 ,2082618980 ,4541539177 
152,智利,14,山西省,828797364 ,1201161100 ,2029958464 
152,智利,15,内蒙古自治区,305666097 ,1337752961 ,1643419058 
152,智利,21,辽宁省,1816919173 ,1400591370 ,3217510543 
152,智利,22,吉林省,107034228 ,499096057 ,606130285 
152,智利,23,黑龙江省,238266972 ,257751665 ,496018637 
152,智利,31,上海市,6950786534 ,47280264569 ,54231051103 
152,智利,32,江苏省,14665748955 ,6888634296 ,21554383251 
152,智利,33,浙江省,27291378735 ,23837483403 ,51128862138 
152,智利,34,安徽省,5701792885 ,18377907602 ,24079700487 
152,智利,35,福建省,7303243664 ,22555280635 ,29858524299 
152,智利,36,江西省,3528784448 ,11724764248 ,15253548696 
152,智利,37,山东省,9124093709 ,16224506896 ,25348600605 
152,智利,41,河南省,2334158991 ,9583857909 ,11918016900 
152,智利,42,湖北省,2525573945 ,6991730606 ,9517304551 
152,智利,43,湖南省,1872034462 ,4000758921 ,5872793383 
152,智利,44,广东省,15653206351 ,20881837218 ,36535043569 
152,智利,45,广西壮族自治区,1321142386 ,11176363144 ,12497505530 
152,智利,46,海南省,45530245 ,711564541 ,757094786 
152,智利,50,重庆市,4118602056 ,1218472922 ,5337074978 
152,智利,51,四川省,828785758 ,3960308100 ,4789093858 
152,智利,52,贵州省,319161698 ,72059964 ,391221662 
152,智利,53,云南省,657642208 ,4227659256 ,4885301464 
152,智利,54,西藏自治区,7286306 ,611538 ,7897844 
152,智利,61,陕西省,962171747 ,5008997365 ,5971169112 
152,智利,62,甘肃省,10245900 ,1069725856 ,1079971756 
152,智利,63,青海省,37955743 ,0 ,37955743 
152,智利,64,宁夏回族自治区,38510461 ,472791 ,38983252 
152,智利,65,新疆维吾尔自治区,53316357 ,226315570 ,279631927 
156,中国,11,北京市,0 ,11745065329 ,11745065329 
156,中国,12,天津市,0 ,8214854139 ,8214854139 
156,中国,13,河北省,0 ,706291708 ,706291708 
156,中国,14,山西省,0 ,1368857592 ,1368857592 
156,中国,15,内蒙古自治区,0 ,41243493 ,41243493 
156,中国,21,辽宁省,0 ,2502788771 ,2502788771 
156,中国,22,吉林省,0 ,2202061649 ,2202061649 
156,中国,23,黑龙江省,0 ,146261142 ,146261142 
156,中国,31,上海市,0 ,55154130322 ,55154130322 
156,中国,32,江苏省,0 ,56695843328 ,56695843328 
156,中国,33,浙江省,0 ,11666945033 ,11666945033 
156,中国,34,安徽省,0 ,7033301764 ,7033301764 
156,中国,35,福建省,0 ,8926154517 ,8926154517 
156,中国,36,江西省,0 ,13196652605 ,13196652605 
156,中国,37,山东省,0 ,15230184182 ,15230184182 
156,中国,41,河南省,0 ,6178118114 ,6178118114 
156,中国,42,湖北省,0 ,8251740276 ,8251740276 
156,中国,43,湖南省,0 ,12412146863 ,12412146863 
156,中国,44,广东省,0 ,341606407057 ,341606407057 
156,中国,45,广西壮族自治区,0 ,6579263320 ,6579263320 
156,中国,46,海南省,0 ,2752656093 ,2752656093 
156,中国,50,重庆市,0 ,14999200258 ,14999200258 
156,中国,51,四川省,0 ,11543133860 ,11543133860 
156,中国,52,贵州省,0 ,1798228416 ,1798228416 
156,中国,53,云南省,0 ,2655933197 ,2655933197 
156,中国,54,西藏自治区,0 ,445902 ,445902 
156,中国,61,陕西省,0 ,4363365735 ,4363365735 
156,中国,62,甘肃省,0 ,693190867 ,693190867 
156,中国,63,青海省,0 ,1588478 ,1588478 
156,中国,64,宁夏回族自治区,0 ,9257079 ,9257079 
156,中国,65,新疆维吾尔自治区,0 ,38573554 ,38573554 
158,中国台湾,11,北京市,8588317331 ,19804951689 ,28393269020 
158,中国台湾,12,天津市,5767371106 ,11812335356 ,17579706462 
158,中国台湾,13,河北省,3728705397 ,2061358266 ,5790063663 
158,中国台湾,14,山西省,923452857 ,9130865463 ,10054318320 
158,中国台湾,15,内蒙古自治区,769204458 ,2167517602 ,2936722060 
158,中国台湾,21,辽宁省,17930573398 ,2701145514 ,20631718912 
158,中国台湾,22,吉林省,325665927 ,1197240721 ,1522906648 
158,中国台湾,23,黑龙江省,358863489 ,247140470 ,606003959 
158,中国台湾,31,上海市,65078470528 ,137305722397 ,202384192925 
158,中国台湾,32,江苏省,87654082347 ,213911543529 ,301565625876 
158,中国台湾,33,浙江省,27872104920 ,51595239758 ,79467344678 
158,中国台湾,34,安徽省,7145550723 ,20451559083 ,27597109806 
158,中国台湾,35,福建省,45582033065 ,31543185026 ,77125218091 
158,中国台湾,36,江西省,5016615187 ,12340073975 ,17356689162 
158,中国台湾,37,山东省,13398853080 ,35233596656 ,48632449736 
158,中国台湾,41,河南省,2597333221 ,59315067801 ,61912401022 
158,中国台湾,42,湖北省,6438186820 ,20026847746 ,26465034566 
158,中国台湾,43,湖南省,4066592480 ,12048482238 ,16115074718 
158,中国台湾,44,广东省,66312689494 ,416663596232 ,482976285726 
158,中国台湾,45,广西壮族自治区,1495198414 ,16268260147 ,17763458561 
158,中国台湾,46,海南省,322644957 ,1613649509 ,1936294466 
158,中国台湾,50,重庆市,11089883827 ,38900424459 ,49990308286 
158,中国台湾,51,四川省,6186882583 ,33679805236 ,39866687819 
158,中国台湾,52,贵州省,261373411 ,3674893641 ,3936267052 
158,中国台湾,53,云南省,1133028849 ,6181342204 ,7314371053 
158,中国台湾,54,西藏自治区,915754 ,14547761 ,15463515 
158,中国台湾,61,陕西省,21419890869 ,32299529176 ,53719420045 
158,中国台湾,62,甘肃省,376333487 ,2214172931 ,2590506418 
158,中国台湾,63,青海省,23014165 ,2377001 ,25391166 
158,中国台湾,64,宁夏回族自治区,249601316 ,96792605 ,346393921 
158,中国台湾,65,新疆维吾尔自治区,146106339 ,1258947081 ,1405053420 
166,特克斯和凯科斯群岛,11,北京市,24384 ,350 ,24734 
166,特克斯和凯科斯群岛,12,天津市,245769 ,0 ,245769 
166,特克斯和凯科斯群岛,13,河北省,3853071 ,0 ,3853071 
166,特克斯和凯科斯群岛,21,辽宁省,225018 ,0 ,225018 
166,特克斯和凯科斯群岛,23,黑龙江省,29637 ,0 ,29637 
166,特克斯和凯科斯群岛,31,上海市,1066082 ,216 ,1066298 
166,特克斯和凯科斯群岛,32,江苏省,5273497 ,0 ,5273497 
166,特克斯和凯科斯群岛,33,浙江省,6975728 ,0 ,6975728 
166,特克斯和凯科斯群岛,34,安徽省,1314472 ,0 ,1314472 
166,特克斯和凯科斯群岛,35,福建省,2489063 ,28305 ,2517368 
166,特克斯和凯科斯群岛,36,江西省,1490313 ,0 ,1490313 
166,特克斯和凯科斯群岛,37,山东省,7079265 ,0 ,7079265 
166,特克斯和凯科斯群岛,41,河南省,809790 ,0 ,809790 
166,特克斯和凯科斯群岛,42,湖北省,101086 ,0 ,101086 
166,特克斯和凯科斯群岛,43,湖南省,6312 ,0 ,6312 
166,特克斯和凯科斯群岛,44,广东省,13098679 ,482945 ,13581624 
166,特克斯和凯科斯群岛,45,广西壮族自治区,1865390 ,0 ,1865390 
166,特克斯和凯科斯群岛,50,重庆市,1623 ,0 ,1623 
166,特克斯和凯科斯群岛,53,云南省,1258482 ,0 ,1258482 
170,哥伦比亚,11,北京市,3692867922 ,23781200312 ,27474068234 
170,哥伦比亚,12,天津市,1696770382 ,74271809 ,1771042191 
170,哥伦比亚,13,河北省,1469646436 ,4648038 ,1474294474 
170,哥伦比亚,14,山西省,668814183 ,1479132332 ,2147946515 
170,哥伦比亚,15,内蒙古自治区,219671424 ,910 ,219672334 
170,哥伦比亚,21,辽宁省,1562256969 ,840364 ,1563097333 
170,哥伦比亚,22,吉林省,78251627 ,0 ,78251627 
170,哥伦比亚,23,黑龙江省,168057331 ,157753 ,168215084 
170,哥伦比亚,31,上海市,4128881871 ,388352897 ,4517234768 
170,哥伦比亚,32,江苏省,10116246962 ,382075625 ,10498322587 
170,哥伦比亚,33,浙江省,17123862362 ,1191409244 ,18315271606 
170,哥伦比亚,34,安徽省,1778444024 ,98400931 ,1876844955 
170,哥伦比亚,35,福建省,3911900973 ,782559492 ,4694460465 
170,哥伦比亚,36,江西省,1794751326 ,24508280 ,1819259606 
170,哥伦比亚,37,山东省,6797739710 ,4235803756 ,11033543466 
170,哥伦比亚,41,河南省,1465537383 ,163384296 ,1628921679 
170,哥伦比亚,42,湖北省,1408335153 ,10683937 ,1419019090 
170,哥伦比亚,43,湖南省,1194515451 ,1625 ,1194517076 
170,哥伦比亚,44,广东省,14175495157 ,1519227540 ,15694722697 
170,哥伦比亚,45,广西壮族自治区,472367675 ,289870840 ,762238515 
170,哥伦比亚,46,海南省,120805515 ,3146 ,120808661 
170,哥伦比亚,50,重庆市,3889130688 ,89193636 ,3978324324 
170,哥伦比亚,51,四川省,1012230061 ,214915852 ,1227145913 
170,哥伦比亚,52,贵州省,94662667 ,165306983 ,259969650 
170,哥伦比亚,53,云南省,437132553 ,119823577 ,556956130 
170,哥伦比亚,54,西藏自治区,11778674 ,0 ,11778674 
170,哥伦比亚,61,陕西省,487814549 ,469999 ,488284548 
170,哥伦比亚,62,甘肃省,33480325 ,107941695 ,141422020 
170,哥伦比亚,63,青海省,1371342 ,0 ,1371342 
170,哥伦比亚,64,宁夏回族自治区,69800150 ,0 ,69800150 
170,哥伦比亚,65,新疆维吾尔自治区,89330246 ,128 ,89330374 
174,科摩罗,11,北京市,31701365 ,1133 ,31702498 
174,科摩罗,12,天津市,493314 ,0 ,493314 
174,科摩罗,13,河北省,6600663 ,0 ,6600663 
174,科摩罗,21,辽宁省,699647 ,538 ,700185 
174,科摩罗,31,上海市,2662067 ,69085 ,2731152 
174,科摩罗,32,江苏省,17432630 ,186854 ,17619484 
174,科摩罗,33,浙江省,46115856 ,1220 ,46117076 
174,科摩罗,34,安徽省,8474094 ,0 ,8474094 
174,科摩罗,35,福建省,23278095 ,0 ,23278095 
174,科摩罗,36,江西省,22286633 ,0 ,22286633 
174,科摩罗,37,山东省,27701238 ,0 ,27701238 
174,科摩罗,41,河南省,3863893 ,0 ,3863893 
174,科摩罗,42,湖北省,6604284 ,0 ,6604284 
174,科摩罗,43,湖南省,8565812 ,0 ,8565812 
174,科摩罗,44,广东省,44450326 ,179255 ,44629581 
174,科摩罗,45,广西壮族自治区,1371391 ,0 ,1371391 
174,科摩罗,50,重庆市,2120775 ,0 ,2120775 
174,科摩罗,51,四川省,5193510 ,0 ,5193510 
174,科摩罗,52,贵州省,1341874 ,0 ,1341874 
174,科摩罗,53,云南省,9226208 ,0 ,9226208 
174,科摩罗,61,陕西省,6085676 ,0 ,6085676 
174,科摩罗,64,宁夏回族自治区,321637 ,0 ,321637 
174,科摩罗,65,新疆维吾尔自治区,39296 ,0 ,39296 
175,马约特,11,北京市,858 ,0 ,858 
175,马约特,12,天津市,3050590 ,15196 ,3065786 
175,马约特,13,河北省,6615588 ,0 ,6615588 
175,马约特,14,山西省,29370 ,47978 ,77348 
175,马约特,21,辽宁省,487053 ,0 ,487053 
175,马约特,23,黑龙江省,812801 ,0 ,812801 
175,马约特,31,上海市,1571437 ,0 ,1571437 
175,马约特,32,江苏省,9242962 ,78178 ,9321140 
175,马约特,33,浙江省,28876855 ,0 ,28876855 
175,马约特,34,安徽省,8969058 ,0 ,8969058 
175,马约特,35,福建省,14261980 ,2112 ,14264092 
175,马约特,36,江西省,8236027 ,0 ,8236027 
175,马约特,37,山东省,64823140 ,0 ,64823140 
175,马约特,41,河南省,4963655 ,0 ,4963655 
175,马约特,42,湖北省,8193989 ,0 ,8193989 
175,马约特,43,湖南省,24333986 ,0 ,24333986 
175,马约特,44,广东省,62449768 ,15548 ,62465316 
175,马约特,45,广西壮族自治区,1342872 ,0 ,1342872 
175,马约特,50,重庆市,219812 ,0 ,219812 
175,马约特,51,四川省,13031239 ,0 ,13031239 
175,马约特,52,贵州省,1345092 ,0 ,1345092 
175,马约特,53,云南省,17209125 ,0 ,17209125 
175,马约特,61,陕西省,10782 ,0 ,10782 
175,马约特,63,青海省,635003 ,0 ,635003 
178,刚果(布),11,北京市,158682576 ,16246135927 ,16404818503 
178,刚果(布),12,天津市,27239918 ,6433460 ,33673378 
178,刚果(布),13,河北省,42822343 ,201045 ,43023388 
178,刚果(布),14,山西省,26559 ,0 ,26559 
178,刚果(布),15,内蒙古自治区,3291489 ,0 ,3291489 
178,刚果(布),21,辽宁省,46694758 ,2626517 ,49321275 
178,刚果(布),23,黑龙江省,10585141 ,0 ,10585141 
178,刚果(布),31,上海市,63187390 ,148200707 ,211388097 
178,刚果(布),32,江苏省,164899667 ,365843898 ,530743565 
178,刚果(布),33,浙江省,947387171 ,2695522267 ,3642909438 
178,刚果(布),34,安徽省,45309931 ,34608737 ,79918668 
178,刚果(布),35,福建省,145401832 ,105680346 ,251082178 
178,刚果(布),36,江西省,158062686 ,26216830 ,184279516 
178,刚果(布),37,山东省,475275799 ,8613807456 ,9089083255 
178,刚果(布),41,河南省,15618017 ,28313021 ,43931038 
178,刚果(布),42,湖北省,59071902 ,1130633 ,60202535 
178,刚果(布),43,湖南省,171732100 ,74891516 ,246623616 
178,刚果(布),44,广东省,1238342596 ,46270801 ,1284613397 
178,刚果(布),45,广西壮族自治区,42539011 ,586427970 ,628966981 
178,刚果(布),46,海南省,244501281 ,0 ,244501281 
178,刚果(布),50,重庆市,56845483 ,206645471 ,263490954 
178,刚果(布),51,四川省,134485323 ,456 ,134485779 
178,刚果(布),52,贵州省,3663080 ,0 ,3663080 
178,刚果(布),53,云南省,7771399 ,0 ,7771399 
178,刚果(布),61,陕西省,40261879 ,1842877 ,42104756 
178,刚果(布),65,新疆维吾尔自治区,8687650 ,0 ,8687650 
180,刚果(金),11,北京市,2084758453 ,1462468932 ,3547227385 
180,刚果(金),12,天津市,218277293 ,31820134 ,250097427 
180,刚果(金),13,河北省,404795250 ,34841883 ,439637133 
180,刚果(金),14,山西省,9643138 ,247116257 ,256759395 
180,刚果(金),15,内蒙古自治区,27948952 ,544785492 ,572734444 
180,刚果(金),21,辽宁省,344761881 ,169757108 ,514518989 
180,刚果(金),22,吉林省,18780871 ,265141886 ,283922757 
180,刚果(金),23,黑龙江省,21420908 ,65793976 ,87214884 
180,刚果(金),31,上海市,3335460568 ,9051317956 ,12386778524 
180,刚果(金),32,江苏省,1835249642 ,10821850364 ,12657100006 
180,刚果(金),33,浙江省,2760265965 ,22162036927 ,24922302892 
180,刚果(金),34,安徽省,413674564 ,3722527074 ,4136201638 
180,刚果(金),35,福建省,1467791400 ,6111852659 ,7579644059 
180,刚果(金),36,江西省,531965416 ,4604523741 ,5136489157 
180,刚果(金),37,山东省,1933463136 ,669656522 ,2603119658 
180,刚果(金),41,河南省,1048949177 ,823349158 ,1872298335 
180,刚果(金),42,湖北省,553623338 ,1708688021 ,2262311359 
180,刚果(金),43,湖南省,375325601 ,3835970686 ,4211296287 
180,刚果(金),44,广东省,3565476559 ,6432738971 ,9998215530 
180,刚果(金),45,广西壮族自治区,181163078 ,2871617930 ,3052781008 
180,刚果(金),46,海南省,642197860 ,588353396 ,1230551256 
180,刚果(金),50,重庆市,330735892 ,1261474329 ,1592210221 
180,刚果(金),51,四川省,250782966 ,1023270860 ,1274053826 
180,刚果(金),52,贵州省,17714031 ,441966178 ,459680209 
180,刚果(金),53,云南省,101809742 ,2605742785 ,2707552527 
180,刚果(金),54,西藏自治区,1099567266 ,0 ,1099567266 
180,刚果(金),61,陕西省,328401447 ,1421799297 ,1750200744 
180,刚果(金),62,甘肃省,67093504 ,3549241120 ,3616334624 
180,刚果(金),63,青海省,1273750 ,0 ,1273750 
180,刚果(金),64,宁夏回族自治区,747500 ,110535127 ,111282627 
180,刚果(金),65,新疆维吾尔自治区,20181449 ,0 ,20181449 
184,库克群岛,11,北京市,4456026 ,683 ,4456709 
184,库克群岛,12,天津市,688767 ,0 ,688767 
184,库克群岛,13,河北省,474093 ,0 ,474093 
184,库克群岛,21,辽宁省,1150866 ,205774 ,1356640 
184,库克群岛,31,上海市,1202979 ,439 ,1203418 
184,库克群岛,32,江苏省,1231817 ,0 ,1231817 
184,库克群岛,33,浙江省,39985186 ,1362246 ,41347432 
184,库克群岛,34,安徽省,312199 ,0 ,312199 
184,库克群岛,35,福建省,474706 ,0 ,474706 
184,库克群岛,36,江西省,117 ,0 ,117 
184,库克群岛,37,山东省,2410493 ,1048234 ,3458727 
184,库克群岛,41,河南省,51248 ,0 ,51248 
184,库克群岛,42,湖北省,2627504 ,0 ,2627504 
184,库克群岛,43,湖南省,198145 ,0 ,198145 
184,库克群岛,44,广东省,10420184 ,14973 ,10435157 
184,库克群岛,51,四川省,274238 ,0 ,274238 
188,哥斯达黎加,11,北京市,199557375 ,681884750 ,881442125 
188,哥斯达黎加,12,天津市,223866122 ,593484327 ,817350449 
188,哥斯达黎加,13,河北省,320066067 ,59604225 ,379670292 
188,哥斯达黎加,14,山西省,85278969 ,11875329 ,97154298 
188,哥斯达黎加,15,内蒙古自治区,23148635 ,2848 ,23151483 
188,哥斯达黎加,21,辽宁省,157855957 ,9736402 ,167592359 
188,哥斯达黎加,22,吉林省,7413657 ,764722 ,8178379 
188,哥斯达黎加,23,黑龙江省,20355877 ,2718 ,20358595 
188,哥斯达黎加,31,上海市,731288038 ,2698909455 ,3430197493 
188,哥斯达黎加,32,江苏省,1557015270 ,214297078 ,1771312348 
188,哥斯达黎加,33,浙江省,2070751037 ,71008388 ,2141759425 
188,哥斯达黎加,34,安徽省,410417095 ,30179615 ,440596710 
188,哥斯达黎加,35,福建省,675668465 ,740194904 ,1415863369 
188,哥斯达黎加,36,江西省,200661674 ,3700599 ,204362273 
188,哥斯达黎加,37,山东省,1400822473 ,514061167 ,1914883640 
188,哥斯达黎加,41,河南省,183953870 ,8851675 ,192805545 
188,哥斯达黎加,42,湖北省,195023407 ,70576741 ,265600148 
188,哥斯达黎加,43,湖南省,253758796 ,22411180 ,276169976 
188,哥斯达黎加,44,广东省,2226912793 ,2977612241 ,5204525034 
188,哥斯达黎加,45,广西壮族自治区,146895527 ,103298918 ,250194445 
188,哥斯达黎加,46,海南省,69843698 ,9760575 ,79604273 
188,哥斯达黎加,50,重庆市,476195930 ,25700206 ,501896136 
188,哥斯达黎加,51,四川省,174469613 ,6037980 ,180507593 
188,哥斯达黎加,52,贵州省,13237570 ,8805 ,13246375 
188,哥斯达黎加,53,云南省,24081697 ,185623 ,24267320 
188,哥斯达黎加,61,陕西省,27820093 ,713647 ,28533740 
188,哥斯达黎加,62,甘肃省,3298038 ,0 ,3298038 
188,哥斯达黎加,63,青海省,244686 ,0 ,244686 
188,哥斯达黎加,64,宁夏回族自治区,18291968 ,0 ,18291968 
188,哥斯达黎加,65,新疆维吾尔自治区,16950973 ,51258244 ,68209217 
191,克罗地亚,11,北京市,706547328 ,39127212 ,745674540 
191,克罗地亚,12,天津市,145800846 ,15362057 ,161162903 
191,克罗地亚,13,河北省,131770034 ,3467795 ,135237829 
191,克罗地亚,14,山西省,7095451 ,0 ,7095451 
191,克罗地亚,15,内蒙古自治区,23231393 ,0 ,23231393 
191,克罗地亚,21,辽宁省,116037315 ,86450814 ,202488129 
191,克罗地亚,22,吉林省,26656904 ,14840741 ,41497645 
191,克罗地亚,23,黑龙江省,26337386 ,7098826 ,33436212 
191,克罗地亚,31,上海市,497767916 ,130098908 ,627866824 
191,克罗地亚,32,江苏省,1411872747 ,116577200 ,1528449947 
191,克罗地亚,33,浙江省,2935832717 ,168977557 ,3104810274 
191,克罗地亚,34,安徽省,411754592 ,2217971 ,413972563 
191,克罗地亚,35,福建省,550351444 ,51772940 ,602124384 
191,克罗地亚,36,江西省,171984077 ,1948941 ,173933018 
191,克罗地亚,37,山东省,816856189 ,35991817 ,852848006 
191,克罗地亚,41,河南省,99266791 ,11776 ,99278567 
191,克罗地亚,42,湖北省,92179374 ,686296 ,92865670 
191,克罗地亚,43,湖南省,138471045 ,1107974 ,139579019 
191,克罗地亚,44,广东省,2751501901 ,177802075 ,2929303976 
191,克罗地亚,45,广西壮族自治区,34862682 ,2092594 ,36955276 
191,克罗地亚,46,海南省,12276269 ,244785 ,12521054 
191,克罗地亚,50,重庆市,166942027 ,1349340 ,168291367 
191,克罗地亚,51,四川省,104496852 ,1192944 ,105689796 
191,克罗地亚,52,贵州省,12581109 ,0 ,12581109 
191,克罗地亚,53,云南省,25378495 ,137072 ,25515567 
191,克罗地亚,54,西藏自治区,6652909 ,0 ,6652909 
191,克罗地亚,61,陕西省,23865986 ,2805334 ,26671320 
191,克罗地亚,62,甘肃省,3060650 ,0 ,3060650 
191,克罗地亚,64,宁夏回族自治区,458953 ,0 ,458953 
191,克罗地亚,65,新疆维吾尔自治区,14039800 ,0 ,14039800 
192,古巴,11,北京市,265701640 ,823879068 ,1089580708 
192,古巴,12,天津市,62930711 ,20459831 ,83390542 
192,古巴,13,河北省,30306789 ,709 ,30307498 
192,古巴,14,山西省,135487 ,310491635 ,310627122 
192,古巴,15,内蒙古自治区,1856016 ,0 ,1856016 
192,古巴,21,辽宁省,36844340 ,1469 ,36845809 
192,古巴,22,吉林省,9231994 ,0 ,9231994 
192,古巴,23,黑龙江省,1279118 ,385900 ,1665018 
192,古巴,31,上海市,89926274 ,17699949 ,107626223 
192,古巴,32,江苏省,271385199 ,44183841 ,315569040 
192,古巴,33,浙江省,419388538 ,588088430 ,1007476968 
192,古巴,34,安徽省,32704919 ,0 ,32704919 
192,古巴,35,福建省,172226321 ,246673433 ,418899754 
192,古巴,36,江西省,13147494 ,147743066 ,160890560 
192,古巴,37,山东省,216733492 ,4483 ,216737975 
192,古巴,41,河南省,18567948 ,8782656 ,27350604 
192,古巴,42,湖北省,19963554 ,0 ,19963554 
192,古巴,43,湖南省,41079489 ,17228520 ,58308009 
192,古巴,44,广东省,333678234 ,23827434 ,357505668 
192,古巴,45,广西壮族自治区,1154403 ,38551448 ,39705851 
192,古巴,46,海南省,767985 ,3276730 ,4044715 
192,古巴,50,重庆市,8162749 ,34794992 ,42957741 
192,古巴,51,四川省,24774979 ,27825 ,24802804 
192,古巴,52,贵州省,2830380 ,0 ,2830380 
192,古巴,53,云南省,6731350 ,16654181 ,23385531 
192,古巴,61,陕西省,2456865 ,123155007 ,125611872 
192,古巴,62,甘肃省,1262930 ,0 ,1262930 
192,古巴,64,宁夏回族自治区,174645 ,0 ,174645 
196,塞浦路斯,11,北京市,948743566 ,44779445 ,993523011 
196,塞浦路斯,12,天津市,72299609 ,10832030 ,83131639 
196,塞浦路斯,13,河北省,52521686 ,119343 ,52641029 
196,塞浦路斯,14,山西省,2129093 ,0 ,2129093 
196,塞浦路斯,15,内蒙古自治区,2068577 ,0 ,2068577 
196,塞浦路斯,21,辽宁省,102486365 ,2467265 ,104953630 
196,塞浦路斯,22,吉林省,2229967 ,0 ,2229967 
196,塞浦路斯,23,黑龙江省,3946075 ,0 ,3946075 
196,塞浦路斯,31,上海市,194411367 ,34431296 ,228842663 
196,塞浦路斯,32,江苏省,300085519 ,1761809 ,301847328 
196,塞浦路斯,33,浙江省,1253836706 ,12376650 ,1266213356 
196,塞浦路斯,34,安徽省,51291858 ,180 ,51292038 
196,塞浦路斯,35,福建省,88583322 ,2766043 ,91349365 
196,塞浦路斯,36,江西省,37049806 ,6581 ,37056387 
196,塞浦路斯,37,山东省,1170370631 ,2099389 ,1172470020 
196,塞浦路斯,41,河南省,27771525 ,2460 ,27773985 
196,塞浦路斯,42,湖北省,46092485 ,0 ,46092485 
196,塞浦路斯,43,湖南省,116886207 ,25886761 ,142772968 
196,塞浦路斯,44,广东省,944087070 ,15613249 ,959700319 
196,塞浦路斯,45,广西壮族自治区,3244316 ,1441573 ,4685889 
196,塞浦路斯,46,海南省,1711939 ,238 ,1712177 
196,塞浦路斯,50,重庆市,31567351 ,0 ,31567351 
196,塞浦路斯,51,四川省,14233563 ,13566 ,14247129 
196,塞浦路斯,52,贵州省,1583349 ,0 ,1583349 
196,塞浦路斯,53,云南省,2631995 ,0 ,2631995 
196,塞浦路斯,54,西藏自治区,396442 ,0 ,396442 
196,塞浦路斯,61,陕西省,42893166 ,0 ,42893166 
196,塞浦路斯,62,甘肃省,103337 ,0 ,103337 
196,塞浦路斯,64,宁夏回族自治区,1306823 ,0 ,1306823 
196,塞浦路斯,65,新疆维吾尔自治区,1996975 ,0 ,1996975 
203,捷克,11,北京市,974041967 ,2618548313 ,3592590280 
203,捷克,12,天津市,1643365284 ,707798113 ,2351163397 
203,捷克,13,河北省,484929258 ,103585419 ,588514677 
203,捷克,14,山西省,3684847299 ,54316446 ,3739163745 
203,捷克,15,内蒙古自治区,7669346 ,5420360 ,13089706 
203,捷克,21,辽宁省,670132058 ,3836430946 ,4506563004 
203,捷克,22,吉林省,101940423 ,2688975316 ,2790915739 
203,捷克,23,黑龙江省,33117799 ,112123714 ,145241513 
203,捷克,31,上海市,11864297122 ,5481721704 ,17346018826 
203,捷克,32,江苏省,15877036378 ,3939515447 ,19816551825 
203,捷克,33,浙江省,8209665142 ,940810508 ,9150475650 
203,捷克,34,安徽省,1467727962 ,352401579 ,1820129541 
203,捷克,35,福建省,2667821153 ,1072196313 ,3740017466 
203,捷克,36,江西省,880670391 ,292402630 ,1173073021 
203,捷克,37,山东省,2761092477 ,537080211 ,3298172688 
203,捷克,41,河南省,12259372981 ,33514852 ,12292887833 
203,捷克,42,湖北省,1239002289 ,277163492 ,1516165781 
203,捷克,43,湖南省,356026067 ,120065839 ,476091906 
203,捷克,44,广东省,16312215345 ,3018037411 ,19330252756 
203,捷克,45,广西壮族自治区,263549758 ,22361210 ,285910968 
203,捷克,46,海南省,6085080 ,25106267 ,31191347 
203,捷克,50,重庆市,3518839782 ,178278038 ,3697117820 
203,捷克,51,四川省,1397855359 ,339564963 ,1737420322 
203,捷克,52,贵州省,27953300 ,4250770 ,32204070 
203,捷克,53,云南省,68513135 ,11191054 ,79704189 
203,捷克,54,西藏自治区,8 ,64213 ,64221 
203,捷克,61,陕西省,1372330415 ,283653238 ,1655983653 
203,捷克,62,甘肃省,29381158 ,738308 ,30119466 
203,捷克,63,青海省,500893 ,0 ,500893 
203,捷克,64,宁夏回族自治区,48449914 ,15335332 ,63785246 
203,捷克,65,新疆维吾尔自治区,18158517 ,609402 ,18767919 
204,贝宁,11,北京市,648684203 ,805675505 ,1454359708 
204,贝宁,12,天津市,205079770 ,60094164 ,265173934 
204,贝宁,13,河北省,109495025 ,34019133 ,143514158 
204,贝宁,14,山西省,2774271 ,0 ,2774271 
204,贝宁,15,内蒙古自治区,19494018 ,0 ,19494018 
204,贝宁,21,辽宁省,49866288 ,62222769 ,112089057 
204,贝宁,22,吉林省,42715 ,0 ,42715 
204,贝宁,23,黑龙江省,6921061 ,36240514 ,43161575 
204,贝宁,31,上海市,226413735 ,11495292 ,237909027 
204,贝宁,32,江苏省,505797128 ,40019380 ,545816508 
204,贝宁,33,浙江省,1797597582 ,155165329 ,1952762911 
204,贝宁,34,安徽省,157870221 ,154029671 ,311899892 
204,贝宁,35,福建省,363673203 ,587014 ,364260217 
204,贝宁,36,江西省,213770933 ,0 ,213770933 
204,贝宁,37,山东省,1788369980 ,81563174 ,1869933154 
204,贝宁,41,河南省,91809757 ,6170 ,91815927 
204,贝宁,42,湖北省,139795988 ,28368924 ,168164912 
204,贝宁,43,湖南省,252460432 ,195214 ,252655646 
204,贝宁,44,广东省,1192914660 ,6497403 ,1199412063 
204,贝宁,45,广西壮族自治区,32439214 ,0 ,32439214 
204,贝宁,46,海南省,2123104 ,0 ,2123104 
204,贝宁,50,重庆市,72333315 ,0 ,72333315 
204,贝宁,51,四川省,103054680 ,4425 ,103059105 
204,贝宁,52,贵州省,5852487 ,0 ,5852487 
204,贝宁,53,云南省,52682496 ,0 ,52682496 
204,贝宁,61,陕西省,38303833 ,0 ,38303833 
204,贝宁,62,甘肃省,1913188 ,0 ,1913188 
204,贝宁,63,青海省,438097 ,0 ,438097 
204,贝宁,64,宁夏回族自治区,10187 ,0 ,10187 
204,贝宁,65,新疆维吾尔自治区,6512365 ,0 ,6512365 
208,丹麦,11,北京市,632746630 ,2900401677 ,3533148307 
208,丹麦,12,天津市,5194086205 ,11724921663 ,16919007868 
208,丹麦,13,河北省,655904248 ,106364076 ,762268324 
208,丹麦,14,山西省,115697939 ,33637240 ,149335179 
208,丹麦,15,内蒙古自治区,56927011 ,14733101 ,71660112 
208,丹麦,21,辽宁省,598636061 ,162155160 ,760791221 
208,丹麦,22,吉林省,34304946 ,75484975 ,109789921 
208,丹麦,23,黑龙江省,130286711 ,20191667 ,150478378 
208,丹麦,31,上海市,2667418331 ,4931860584 ,7599278915 
208,丹麦,32,江苏省,10345032648 ,1803032605 ,12148065253 
208,丹麦,33,浙江省,11222578444 ,1077053230 ,12299631674 
208,丹麦,34,安徽省,1440137144 ,114100445 ,1554237589 
208,丹麦,35,福建省,2915293779 ,420913856 ,3336207635 
208,丹麦,36,江西省,758597468 ,22097113 ,780694581 
208,丹麦,37,山东省,5440936328 ,1381479039 ,6822415367 
208,丹麦,41,河南省,335517155 ,110651385 ,446168540 
208,丹麦,42,湖北省,284085193 ,189656035 ,473741228 
208,丹麦,43,湖南省,357757380 ,61753547 ,419510927 
208,丹麦,44,广东省,8403745870 ,2846546943 ,11250292813 
208,丹麦,45,广西壮族自治区,116065737 ,20974387 ,137040124 
208,丹麦,46,海南省,3756717 ,7767701 ,11524418 
208,丹麦,50,重庆市,352426680 ,225955000 ,578381680 
208,丹麦,51,四川省,775335342 ,50398425 ,825733767 
208,丹麦,52,贵州省,51801178 ,5399910 ,57201088 
208,丹麦,53,云南省,57200257 ,8357978 ,65558235 
208,丹麦,54,西藏自治区,39336545 ,43236 ,39379781 
208,丹麦,61,陕西省,478255573 ,69902902 ,548158475 
208,丹麦,62,甘肃省,8897416 ,2202851 ,11100267 
208,丹麦,63,青海省,110983 ,7255738 ,7366721 
208,丹麦,64,宁夏回族自治区,7648112 ,103182 ,7751294 
208,丹麦,65,新疆维吾尔自治区,6304400 ,120603 ,6425003 
212,多米尼克,11,北京市,191016 ,194113 ,385129 
212,多米尼克,12,天津市,571153 ,0 ,571153 
212,多米尼克,13,河北省,3176425 ,0 ,3176425 
212,多米尼克,15,内蒙古自治区,13 ,0 ,13 
212,多米尼克,21,辽宁省,95760 ,0 ,95760 
212,多米尼克,23,黑龙江省,275390 ,0 ,275390 
212,多米尼克,31,上海市,3592189 ,53484 ,3645673 
212,多米尼克,32,江苏省,4615223 ,212459 ,4827682 
212,多米尼克,33,浙江省,63088134 ,934094 ,64022228 
212,多米尼克,34,安徽省,16940921 ,0 ,16940921 
212,多米尼克,35,福建省,8596416 ,45935 ,8642351 
212,多米尼克,36,江西省,4040785 ,0 ,4040785 
212,多米尼克,37,山东省,23653220 ,0 ,23653220 
212,多米尼克,41,河南省,4819509 ,0 ,4819509 
212,多米尼克,42,湖北省,1834344 ,0 ,1834344 
212,多米尼克,43,湖南省,2808972 ,0 ,2808972 
212,多米尼克,44,广东省,34243994 ,565413 ,34809407 
212,多米尼克,45,广西壮族自治区,490105 ,0 ,490105 
212,多米尼克,50,重庆市,85043 ,0 ,85043 
212,多米尼克,51,四川省,928612 ,0 ,928612 
212,多米尼克,53,云南省,1302346 ,0 ,1302346 
212,多米尼克,54,西藏自治区,1 ,0 ,1 
212,多米尼克,61,陕西省,362878 ,0 ,362878 
212,多米尼克,65,新疆维吾尔自治区,1072694 ,0 ,1072694 
214,多米尼加共和国,11,北京市,205427288 ,353403978 ,558831266 
214,多米尼加共和国,12,天津市,274523366 ,1573232 ,276096598 
214,多米尼加共和国,13,河北省,670847202 ,3048474 ,673895676 
214,多米尼加共和国,14,山西省,14532666 ,496769908 ,511302574 
214,多米尼加共和国,15,内蒙古自治区,31562490 ,20472 ,31582962 
214,多米尼加共和国,21,辽宁省,404101620 ,1772035 ,405873655 
214,多米尼加共和国,22,吉林省,27013639 ,0 ,27013639 
214,多米尼加共和国,23,黑龙江省,21996683 ,7413 ,22004096 
214,多米尼加共和国,31,上海市,820272514 ,504091679 ,1324364193 
214,多米尼加共和国,32,江苏省,2128663264 ,21922270 ,2150585534 
214,多米尼加共和国,33,浙江省,5084840662 ,132703840 ,5217544502 
214,多米尼加共和国,34,安徽省,464012560 ,24676193 ,488688753 
214,多米尼加共和国,35,福建省,1520077973 ,289503167 ,1809581140 
214,多米尼加共和国,36,江西省,698836520 ,852356 ,699688876 
214,多米尼加共和国,37,山东省,2040578275 ,123601984 ,2164180259 
214,多米尼加共和国,41,河南省,491299596 ,501303 ,491800899 
214,多米尼加共和国,42,湖北省,410858491 ,1996774 ,412855265 
214,多米尼加共和国,43,湖南省,689244415 ,117481 ,689361896 
214,多米尼加共和国,44,广东省,3874069702 ,118667185 ,3992736887 
214,多米尼加共和国,45,广西壮族自治区,189929276 ,164564596 ,354493872 
214,多米尼加共和国,46,海南省,17545600 ,0 ,17545600 
214,多米尼加共和国,50,重庆市,603297483 ,3930 ,603301413 
214,多米尼加共和国,51,四川省,226530599 ,256141 ,226786740 
214,多米尼加共和国,52,贵州省,40749405 ,134 ,40749539 
214,多米尼加共和国,53,云南省,112124857 ,255139682 ,367264539 
214,多米尼加共和国,61,陕西省,70140052 ,445347 ,70585399 
214,多米尼加共和国,62,甘肃省,452892 ,0 ,452892 
214,多米尼加共和国,64,宁夏回族自治区,13368461 ,27578 ,13396039 
214,多米尼加共和国,65,新疆维吾尔自治区,9109246 ,0 ,9109246 
218,厄瓜多尔,11,北京市,1065365554 ,8864518770 ,9929884324 
218,厄瓜多尔,12,天津市,425504146 ,3608557785 ,4034061931 
218,厄瓜多尔,13,河北省,1023570182 ,154370570 ,1177940752 
218,厄瓜多尔,14,山西省,29656579 ,3231913 ,32888492 
218,厄瓜多尔,15,内蒙古自治区,103738084 ,0 ,103738084 
218,厄瓜多尔,21,辽宁省,619474995 ,748307288 ,1367782283 
218,厄瓜多尔,22,吉林省,72358196 ,0 ,72358196 
218,厄瓜多尔,23,黑龙江省,61238678 ,152372 ,61391050 
218,厄瓜多尔,31,上海市,1466465323 ,741426933 ,2207892256 
218,厄瓜多尔,32,江苏省,3381299865 ,158092358 ,3539392223 
218,厄瓜多尔,33,浙江省,6777295000 ,3380880919 ,10158175919 
218,厄瓜多尔,34,安徽省,1787332086 ,4918813410 ,6706145496 
218,厄瓜多尔,35,福建省,1242247420 ,518230838 ,1760478258 
218,厄瓜多尔,36,江西省,515192658 ,2568985 ,517761643 
218,厄瓜多尔,37,山东省,3181027383 ,2223940330 ,5404967713 
218,厄瓜多尔,41,河南省,312701686 ,153863088 ,466564774 
218,厄瓜多尔,42,湖北省,706550867 ,41044589 ,747595456 
218,厄瓜多尔,43,湖南省,544708561 ,764766417 ,1309474978 
218,厄瓜多尔,44,广东省,4079663850 ,4871433019 ,8951096869 
218,厄瓜多尔,45,广西壮族自治区,430060122 ,91321392 ,521381514 
218,厄瓜多尔,46,海南省,40609182 ,12649314 ,53258496 
218,厄瓜多尔,50,重庆市,1322655307 ,770315399 ,2092970706 
218,厄瓜多尔,51,四川省,527060504 ,292327 ,527352831 
218,厄瓜多尔,52,贵州省,62973516 ,9696029 ,72669545 
218,厄瓜多尔,53,云南省,187525568 ,7573983 ,195099551 
218,厄瓜多尔,54,西藏自治区,791496 ,0 ,791496 
218,厄瓜多尔,61,陕西省,98464693 ,4391698 ,102856391 
218,厄瓜多尔,62,甘肃省,3487468 ,14777803 ,18265271 
218,厄瓜多尔,63,青海省,506287 ,0 ,506287 
218,厄瓜多尔,64,宁夏回族自治区,76253336 ,1249143 ,77502479 
218,厄瓜多尔,65,新疆维吾尔自治区,38403712 ,27337068 ,65740780 
222,萨尔瓦多,11,北京市,236094153 ,330467705 ,566561858 
222,萨尔瓦多,12,天津市,109942914 ,1514283 ,111457197 
222,萨尔瓦多,13,河北省,276444574 ,129064021 ,405508595 
222,萨尔瓦多,14,山西省,5699840 ,0 ,5699840 
222,萨尔瓦多,15,内蒙古自治区,30268064 ,0 ,30268064 
222,萨尔瓦多,21,辽宁省,163021484 ,386050 ,163407534 
222,萨尔瓦多,22,吉林省,4752378 ,6124685 ,10877063 
222,萨尔瓦多,23,黑龙江省,18872389 ,0 ,18872389 
222,萨尔瓦多,31,上海市,337123174 ,46829905 ,383953079 
222,萨尔瓦多,32,江苏省,1174704645 ,45823317 ,1220527962 
222,萨尔瓦多,33,浙江省,2296102890 ,14744052 ,2310846942 
222,萨尔瓦多,34,安徽省,156546004 ,1803862 ,158349866 
222,萨尔瓦多,35,福建省,420747202 ,70865514 ,491612716 
222,萨尔瓦多,36,江西省,170280170 ,106494 ,170386664 
222,萨尔瓦多,37,山东省,729720872 ,5810543 ,735531415 
222,萨尔瓦多,41,河南省,110450920 ,411625 ,110862545 
222,萨尔瓦多,42,湖北省,122781375 ,118182 ,122899557 
222,萨尔瓦多,43,湖南省,107973270 ,2977572 ,110950842 
222,萨尔瓦多,44,广东省,1227669658 ,585040675 ,1812710333 
222,萨尔瓦多,45,广西壮族自治区,64619046 ,1279797 ,65898843 
222,萨尔瓦多,46,海南省,9415780 ,10314 ,9426094 
222,萨尔瓦多,50,重庆市,276026984 ,15127 ,276042111 
222,萨尔瓦多,51,四川省,73141375 ,658393 ,73799768 
222,萨尔瓦多,52,贵州省,12045310 ,3362 ,12048672 
222,萨尔瓦多,53,云南省,27246523 ,14128 ,27260651 
222,萨尔瓦多,54,西藏自治区,425671 ,0 ,425671 
222,萨尔瓦多,61,陕西省,14513519 ,4022 ,14517541 
222,萨尔瓦多,62,甘肃省,2695264 ,0 ,2695264 
222,萨尔瓦多,64,宁夏回族自治区,54350648 ,0 ,54350648 
222,萨尔瓦多,65,新疆维吾尔自治区,4041355 ,0 ,4041355 
226,赤道几内亚,11,北京市,248162393 ,3718693943 ,3966856336 
226,赤道几内亚,12,天津市,238641836 ,0 ,238641836 
226,赤道几内亚,13,河北省,7717608 ,0 ,7717608 
226,赤道几内亚,14,山西省,512923 ,0 ,512923 
226,赤道几内亚,21,辽宁省,1423377 ,0 ,1423377 
226,赤道几内亚,23,黑龙江省,741169 ,0 ,741169 
226,赤道几内亚,31,上海市,1793742 ,33178776 ,34972518 
226,赤道几内亚,32,江苏省,42397284 ,739139531 ,781536815 
226,赤道几内亚,33,浙江省,335843818 ,405220286 ,741064104 
226,赤道几内亚,34,安徽省,4494321 ,0 ,4494321 
226,赤道几内亚,35,福建省,24668615 ,1979491136 ,2004159751 
226,赤道几内亚,36,江西省,18153908 ,0 ,18153908 
226,赤道几内亚,37,山东省,51546017 ,126089114 ,177635131 
226,赤道几内亚,41,河南省,2177038 ,0 ,2177038 
226,赤道几内亚,42,湖北省,20748188 ,0 ,20748188 
226,赤道几内亚,43,湖南省,27790066 ,1224256 ,29014322 
226,赤道几内亚,44,广东省,113663449 ,5163 ,113668612 
226,赤道几内亚,45,广西壮族自治区,306010 ,0 ,306010 
226,赤道几内亚,50,重庆市,3077906 ,0 ,3077906 
226,赤道几内亚,51,四川省,11579566 ,0 ,11579566 
226,赤道几内亚,53,云南省,8148147 ,0 ,8148147 
226,赤道几内亚,61,陕西省,220148 ,3335 ,223483 
231,埃塞俄比亚,11,北京市,1264466510 ,227455645 ,1491922155 
231,埃塞俄比亚,12,天津市,187614884 ,72526663 ,260141547 
231,埃塞俄比亚,13,河北省,300080374 ,152392778 ,452473152 
231,埃塞俄比亚,14,山西省,14470183 ,18885220 ,33355403 
231,埃塞俄比亚,15,内蒙古自治区,20846934 ,0 ,20846934 
231,埃塞俄比亚,21,辽宁省,58208777 ,48485964 ,106694741 
231,埃塞俄比亚,22,吉林省,3382298 ,8581544 ,11963842 
231,埃塞俄比亚,23,黑龙江省,6945639 ,14816128 ,21761767 
231,埃塞俄比亚,31,上海市,658270597 ,271448305 ,929718902 
231,埃塞俄比亚,32,江苏省,1353770247 ,280915830 ,1634686077 
231,埃塞俄比亚,33,浙江省,2191065830 ,38483287 ,2229549117 
231,埃塞俄比亚,34,安徽省,174412078 ,357836491 ,532248569 
231,埃塞俄比亚,35,福建省,455355165 ,93827193 ,549182358 
231,埃塞俄比亚,36,江西省,193894134 ,22584605 ,216478739 
231,埃塞俄比亚,37,山东省,659734085 ,213813764 ,873547849 
231,埃塞俄比亚,41,河南省,196574938 ,7174828 ,203749766 
231,埃塞俄比亚,42,湖北省,143443284 ,1616533 ,145059817 
231,埃塞俄比亚,43,湖南省,173640456 ,8350719 ,181991175 
231,埃塞俄比亚,44,广东省,2196632397 ,131089402 ,2327721799 
231,埃塞俄比亚,45,广西壮族自治区,135525709 ,21650797 ,157176506 
231,埃塞俄比亚,46,海南省,458547 ,53229882 ,53688429 
231,埃塞俄比亚,50,重庆市,85912821 ,212032363 ,297945184 
231,埃塞俄比亚,51,四川省,277394167 ,1846639 ,279240806 
231,埃塞俄比亚,52,贵州省,2231750 ,0 ,2231750 
231,埃塞俄比亚,53,云南省,40280174 ,4725159 ,45005333 
231,埃塞俄比亚,54,西藏自治区,1 ,0 ,1 
231,埃塞俄比亚,61,陕西省,79660736 ,3464 ,79664200 
231,埃塞俄比亚,62,甘肃省,1315947 ,0 ,1315947 
231,埃塞俄比亚,64,宁夏回族自治区,135339 ,0 ,135339 
231,埃塞俄比亚,65,新疆维吾尔自治区,35096772 ,208369 ,35305141 
232,厄立特里亚,11,北京市,239356098 ,174568 ,239530666 
232,厄立特里亚,12,天津市,5135849 ,0 ,5135849 
232,厄立特里亚,13,河北省,20560876 ,0 ,20560876 
232,厄立特里亚,15,内蒙古自治区,0 ,209202912 ,209202912 
232,厄立特里亚,21,辽宁省,25155917 ,0 ,25155917 
232,厄立特里亚,22,吉林省,0 ,119416746 ,119416746 
232,厄立特里亚,31,上海市,104694320 ,95408997 ,200103317 
232,厄立特里亚,32,江苏省,9395112 ,0 ,9395112 
232,厄立特里亚,33,浙江省,34773348 ,541396031 ,576169379 
232,厄立特里亚,34,安徽省,8530453 ,0 ,8530453 
232,厄立特里亚,35,福建省,1943357 ,433982024 ,435925381 
232,厄立特里亚,36,江西省,554992 ,61877757 ,62432749 
232,厄立特里亚,37,山东省,83342127 ,143157488 ,226499615 
232,厄立特里亚,41,河南省,5695621 ,150106024 ,155801645 
232,厄立特里亚,42,湖北省,3803663 ,0 ,3803663 
232,厄立特里亚,43,湖南省,16877673 ,95359631 ,112237304 
232,厄立特里亚,44,广东省,67740986 ,9199 ,67750185 
232,厄立特里亚,45,广西壮族自治区,535755 ,417062057 ,417597812 
232,厄立特里亚,46,海南省,5563393 ,0 ,5563393 
232,厄立特里亚,50,重庆市,1663944 ,72256719 ,73920663 
232,厄立特里亚,51,四川省,18842291 ,106724 ,18949015 
232,厄立特里亚,61,陕西省,2230078 ,0 ,2230078 
232,厄立特里亚,62,甘肃省,0 ,294429306 ,294429306 
233,爱沙尼亚,11,北京市,27428030 ,177171337 ,204599367 
233,爱沙尼亚,12,天津市,27074462 ,45304565 ,72379027 
233,爱沙尼亚,13,河北省,113611208 ,71141298 ,184752506 
233,爱沙尼亚,14,山西省,25561806 ,213 ,25562019 
233,爱沙尼亚,15,内蒙古自治区,4974107 ,0 ,4974107 
233,爱沙尼亚,21,辽宁省,85435884 ,25849756 ,111285640 
233,爱沙尼亚,22,吉林省,7584445 ,8179760 ,15764205 
233,爱沙尼亚,23,黑龙江省,5159777 ,2043668 ,7203445 
233,爱沙尼亚,31,上海市,280012404 ,190878676 ,470891080 
233,爱沙尼亚,32,江苏省,1224410224 ,379346326 ,1603756550 
233,爱沙尼亚,33,浙江省,915459288 ,81204211 ,996663499 
233,爱沙尼亚,34,安徽省,259371209 ,36154142 ,295525351 
233,爱沙尼亚,35,福建省,125922291 ,53408868 ,179331159 
233,爱沙尼亚,36,江西省,31417164 ,2952668 ,34369832 
233,爱沙尼亚,37,山东省,294705552 ,130983400 ,425688952 
233,爱沙尼亚,41,河南省,28690832 ,2863530 ,31554362 
233,爱沙尼亚,42,湖北省,125584399 ,17782324 ,143366723 
233,爱沙尼亚,43,湖南省,42285885 ,417976 ,42703861 
233,爱沙尼亚,44,广东省,996689749 ,141088668 ,1137778417 
233,爱沙尼亚,45,广西壮族自治区,13082447 ,268121 ,13350568 
233,爱沙尼亚,46,海南省,1524683 ,159526 ,1684209 
233,爱沙尼亚,50,重庆市,120839679 ,8059297 ,128898976 
233,爱沙尼亚,51,四川省,45019437 ,610683 ,45630120 
233,爱沙尼亚,52,贵州省,36064409 ,0 ,36064409 
233,爱沙尼亚,53,云南省,12143937 ,5934998 ,18078935 
233,爱沙尼亚,61,陕西省,32903556 ,602095 ,33505651 
233,爱沙尼亚,62,甘肃省,470910 ,8929278 ,9400188 
233,爱沙尼亚,63,青海省,78 ,0 ,78 
233,爱沙尼亚,64,宁夏回族自治区,8522004 ,0 ,8522004 
233,爱沙尼亚,65,新疆维吾尔自治区,6008086 ,695256 ,6703342 
234,法罗群岛,11,北京市,25216 ,1112122 ,1137338 
234,法罗群岛,12,天津市,0 ,3804674 ,3804674 
234,法罗群岛,13,河北省,34163 ,0 ,34163 
234,法罗群岛,14,山西省,39 ,0 ,39 
234,法罗群岛,21,辽宁省,195 ,2258109 ,2258304 
234,法罗群岛,31,上海市,174310 ,425923588 ,426097898 
234,法罗群岛,32,江苏省,1509333 ,99020 ,1608353 
234,法罗群岛,33,浙江省,1065358 ,0 ,1065358 
234,法罗群岛,34,安徽省,16824 ,0 ,16824 
234,法罗群岛,35,福建省,22422 ,3114320 ,3136742 
234,法罗群岛,36,江西省,3956 ,0 ,3956 
234,法罗群岛,37,山东省,6491372 ,119367853 ,125859225 
234,法罗群岛,41,河南省,5609 ,0 ,5609 
234,法罗群岛,42,湖北省,20159 ,0 ,20159 
234,法罗群岛,43,湖南省,5486 ,0 ,5486 
234,法罗群岛,44,广东省,414985 ,18955757 ,19370742 
234,法罗群岛,50,重庆市,117 ,36235111 ,36235228 
234,法罗群岛,51,四川省,95419 ,0 ,95419 
234,法罗群岛,53,云南省,39 ,0 ,39 
234,法罗群岛,61,陕西省,234 ,34287 ,34521 
242,斐济,11,北京市,57658949 ,16739208 ,74398157 
242,斐济,12,天津市,35894755 ,1245 ,35896000 
242,斐济,13,河北省,50195275 ,430 ,50195705 
242,斐济,14,山西省,1503158 ,0 ,1503158 
242,斐济,15,内蒙古自治区,490982 ,0 ,490982 
242,斐济,21,辽宁省,18635396 ,3877538 ,22512934 
242,斐济,23,黑龙江省,1285484 ,0 ,1285484 
242,斐济,31,上海市,93570583 ,25374693 ,118945276 
242,斐济,32,江苏省,204908510 ,5606401 ,210514911 
242,斐济,33,浙江省,484754294 ,2838195 ,487592489 
242,斐济,34,安徽省,49425009 ,51 ,49425060 
242,斐济,35,福建省,213934208 ,210721 ,214144929 
242,斐济,36,江西省,76267263 ,0 ,76267263 
242,斐济,37,山东省,369438444 ,94713294 ,464151738 
242,斐济,41,河南省,31219448 ,0 ,31219448 
242,斐济,42,湖北省,47855436 ,0 ,47855436 
242,斐济,43,湖南省,84525918 ,0 ,84525918 
242,斐济,44,广东省,448191275 ,31887391 ,480078666 
242,斐济,45,广西壮族自治区,12358586 ,200 ,12358786 
242,斐济,46,海南省,2198213 ,887842 ,3086055 
242,斐济,50,重庆市,11056962 ,109191 ,11166153 
242,斐济,51,四川省,55041006 ,8381 ,55049387 
242,斐济,52,贵州省,21735767 ,0 ,21735767 
242,斐济,53,云南省,10156984 ,0 ,10156984 
242,斐济,61,陕西省,2924024 ,197067 ,3121091 
242,斐济,62,甘肃省,122031 ,0 ,122031 
242,斐济,64,宁夏回族自治区,476827 ,0 ,476827 
242,斐济,65,新疆维吾尔自治区,5208668 ,0 ,5208668 
246,芬兰,11,北京市,328334748 ,3105990830 ,3434325578 
246,芬兰,12,天津市,1495212770 ,354020890 ,1849233660 
246,芬兰,13,河北省,287569388 ,75083888 ,362653276 
246,芬兰,14,山西省,65985826 ,10002756 ,75988582 
246,芬兰,15,内蒙古自治区,18727477 ,501002 ,19228479 
246,芬兰,21,辽宁省,316482926 ,184779515 ,501262441 
246,芬兰,22,吉林省,5536570 ,20560056 ,26096626 
246,芬兰,23,黑龙江省,23301432 ,248160018 ,271461450 
246,芬兰,31,上海市,1442484677 ,3469988362 ,4912473039 
246,芬兰,32,江苏省,5946878289 ,6317772966 ,12264651255 
246,芬兰,33,浙江省,5431328301 ,2182795867 ,7614124168 
246,芬兰,34,安徽省,751166889 ,306825705 ,1057992594 
246,芬兰,35,福建省,2206400760 ,810507892 ,3016908652 
246,芬兰,36,江西省,196537264 ,429496060 ,626033324 
246,芬兰,37,山东省,1347334978 ,2895425887 ,4242760865 
246,芬兰,41,河南省,332998356 ,298354469 ,631352825 
246,芬兰,42,湖北省,117130244 ,307198020 ,424328264 
246,芬兰,43,湖南省,224021749 ,185467683 ,409489432 
246,芬兰,44,广东省,3213347748 ,2056101946 ,5269449694 
246,芬兰,45,广西壮族自治区,43774145 ,787052652 ,830826797 
246,芬兰,46,海南省,971166 ,32134431 ,33105597 
246,芬兰,50,重庆市,235396961 ,218368051 ,453765012 
246,芬兰,51,四川省,107220976 ,23281202 ,130502178 
246,芬兰,52,贵州省,36049478 ,96796 ,36146274 
246,芬兰,53,云南省,5326574 ,28488032 ,33814606 
246,芬兰,54,西藏自治区,1603800 ,0 ,1603800 
246,芬兰,61,陕西省,160727248 ,240666131 ,401393379 
246,芬兰,62,甘肃省,1486395 ,2061682368 ,2063168763 
246,芬兰,63,青海省,23780 ,1346401 ,1370181 
246,芬兰,64,宁夏回族自治区,30354076 ,10550373 ,40904449 
246,芬兰,65,新疆维吾尔自治区,6704482 ,17426864 ,24131346 
250,法国,11,北京市,4639689235 ,15725187537 ,20364876772 
250,法国,12,天津市,5964929589 ,16621665310 ,22586594899 
250,法国,13,河北省,2240825176 ,569725134 ,2810550310 
250,法国,14,山西省,348835403 ,54162590 ,402997993 
250,法国,15,内蒙古自治区,304739907 ,115941057 ,420680964 
250,法国,21,辽宁省,2054174638 ,5791267829 ,7845442467 
250,法国,22,吉林省,603563221 ,1549870675 ,2153433896 
250,法国,23,黑龙江省,174695613 ,1056101105 ,1230796718 
250,法国,31,上海市,16982148464 ,56772646812 ,73754795276 
250,法国,32,江苏省,38187793763 ,12972148055 ,51159941818 
250,法国,33,浙江省,47494237687 ,13206555343 ,60700793030 
250,法国,34,安徽省,3895114564 ,696265711 ,4591380275 
250,法国,35,福建省,10639129825 ,3273365920 ,13912495745 
250,法国,36,江西省,3190731561 ,445354335 ,3636085896 
250,法国,37,山东省,13654576033 ,4132494037 ,17787070070 
250,法国,41,河南省,1702436164 ,888347290 ,2590783454 
250,法国,42,湖北省,4782863454 ,1697825946 ,6480689400 
250,法国,43,湖南省,2865217139 ,395030136 ,3260247275 
250,法国,44,广东省,55573118416 ,21920761567 ,77493879983 
250,法国,45,广西壮族自治区,828807603 ,67963219 ,896770822 
250,法国,46,海南省,119502244 ,7896159462 ,8015661706 
250,法国,50,重庆市,4708479548 ,954711848 ,5663191396 
250,法国,51,四川省,5079286050 ,1564084280 ,6643370330 
250,法国,52,贵州省,629139209 ,77577226 ,706716435 
250,法国,53,云南省,864422085 ,66084508 ,930506593 
250,法国,54,西藏自治区,20265 ,21495542 ,21515807 
250,法国,61,陕西省,4644819007 ,647055011 ,5291874018 
250,法国,62,甘肃省,76102311 ,11306072 ,87408383 
250,法国,63,青海省,53330866 ,2102655 ,55433521 
250,法国,64,宁夏回族自治区,195607333 ,19750518 ,215357851 
250,法国,65,新疆维吾尔自治区,113935891 ,44449784 ,158385675 
254,法属圭亚那,11,北京市,171826 ,910 ,172736 
254,法属圭亚那,12,天津市,1661067 ,0 ,1661067 
254,法属圭亚那,13,河北省,3654279 ,0 ,3654279 
254,法属圭亚那,21,辽宁省,7236 ,0 ,7236 
254,法属圭亚那,23,黑龙江省,604486 ,0 ,604486 
254,法属圭亚那,31,上海市,2445142 ,15 ,2445157 
254,法属圭亚那,32,江苏省,10607608 ,116 ,10607724 
254,法属圭亚那,33,浙江省,72329051 ,0 ,72329051 
254,法属圭亚那,34,安徽省,6007565 ,0 ,6007565 
254,法属圭亚那,35,福建省,21859280 ,719 ,21859999 
254,法属圭亚那,36,江西省,5846308 ,0 ,5846308 
254,法属圭亚那,37,山东省,13282970 ,891 ,13283861 
254,法属圭亚那,41,河南省,4413099 ,0 ,4413099 
254,法属圭亚那,42,湖北省,603021 ,0 ,603021 
254,法属圭亚那,43,湖南省,2221012 ,0 ,2221012 
254,法属圭亚那,44,广东省,50533001 ,0 ,50533001 
254,法属圭亚那,50,重庆市,126506 ,0 ,126506 
254,法属圭亚那,51,四川省,833974 ,0 ,833974 
254,法属圭亚那,53,云南省,2058472 ,0 ,2058472 
254,法属圭亚那,61,陕西省,119548 ,0 ,119548 
254,法属圭亚那,65,新疆维吾尔自治区,1118773 ,0 ,1118773 
258,法属波利尼西亚,11,北京市,10026192 ,338 ,10026530 
258,法属波利尼西亚,12,天津市,51161121 ,0 ,51161121 
258,法属波利尼西亚,13,河北省,14792215 ,0 ,14792215 
258,法属波利尼西亚,14,山西省,557313 ,0 ,557313 
258,法属波利尼西亚,15,内蒙古自治区,47768 ,0 ,47768 
258,法属波利尼西亚,21,辽宁省,13099291 ,0 ,13099291 
258,法属波利尼西亚,22,吉林省,6495457 ,0 ,6495457 
258,法属波利尼西亚,23,黑龙江省,347375 ,0 ,347375 
258,法属波利尼西亚,31,上海市,39992306 ,4122524 ,44114830 
258,法属波利尼西亚,32,江苏省,76569504 ,992829 ,77562333 
258,法属波利尼西亚,33,浙江省,130529455 ,2027784 ,132557239 
258,法属波利尼西亚,34,安徽省,24301472 ,0 ,24301472 
258,法属波利尼西亚,35,福建省,45028512 ,81065 ,45109577 
258,法属波利尼西亚,36,江西省,37221937 ,0 ,37221937 
258,法属波利尼西亚,37,山东省,95145711 ,0 ,95145711 
258,法属波利尼西亚,41,河南省,5696902 ,0 ,5696902 
258,法属波利尼西亚,42,湖北省,13498529 ,0 ,13498529 
258,法属波利尼西亚,43,湖南省,14502368 ,0 ,14502368 
258,法属波利尼西亚,44,广东省,128274825 ,4639072 ,132913897 
258,法属波利尼西亚,45,广西壮族自治区,17456268 ,0 ,17456268 
258,法属波利尼西亚,46,海南省,838523 ,0 ,838523 
258,法属波利尼西亚,50,重庆市,9587618 ,4221987 ,13809605 
258,法属波利尼西亚,51,四川省,13397117 ,12463 ,13409580 
258,法属波利尼西亚,52,贵州省,390 ,0 ,390 
258,法属波利尼西亚,53,云南省,7264371 ,0 ,7264371 
258,法属波利尼西亚,61,陕西省,823760 ,0 ,823760 
258,法属波利尼西亚,62,甘肃省,288086 ,0 ,288086 
258,法属波利尼西亚,65,新疆维吾尔自治区,60044 ,0 ,60044 
262,吉布提,11,北京市,87782296 ,6625 ,87788921 
262,吉布提,12,天津市,286564355 ,0 ,286564355 
262,吉布提,13,河北省,287290502 ,0 ,287290502 
262,吉布提,14,山西省,21394581 ,0 ,21394581 
262,吉布提,15,内蒙古自治区,25800411 ,0 ,25800411 
262,吉布提,21,辽宁省,87235937 ,0 ,87235937 
262,吉布提,23,黑龙江省,15480060 ,0 ,15480060 
262,吉布提,31,上海市,156444288 ,2691 ,156446979 
262,吉布提,32,江苏省,1055077956 ,0 ,1055077956 
262,吉布提,33,浙江省,3320553820 ,19128 ,3320572948 
262,吉布提,34,安徽省,107015914 ,0 ,107015914 
262,吉布提,35,福建省,1339276914 ,0 ,1339276914 
262,吉布提,36,江西省,556285900 ,0 ,556285900 
262,吉布提,37,山东省,3108621497 ,435616827 ,3544238324 
262,吉布提,41,河南省,119627509 ,0 ,119627509 
262,吉布提,42,湖北省,425414454 ,0 ,425414454 
262,吉布提,43,湖南省,1480059430 ,0 ,1480059430 
262,吉布提,44,广东省,2035324803 ,4551 ,2035329354 
262,吉布提,45,广西壮族自治区,82858026 ,0 ,82858026 
262,吉布提,46,海南省,145380282 ,0 ,145380282 
262,吉布提,50,重庆市,223910126 ,0 ,223910126 
262,吉布提,51,四川省,350184525 ,0 ,350184525 
262,吉布提,52,贵州省,79031116 ,0 ,79031116 
262,吉布提,53,云南省,156877396 ,0 ,156877396 
262,吉布提,61,陕西省,77246613 ,0 ,77246613 
262,吉布提,62,甘肃省,17373920 ,0 ,17373920 
262,吉布提,64,宁夏回族自治区,5439839 ,0 ,5439839 
262,吉布提,65,新疆维吾尔自治区,28701315 ,0 ,28701315 
266,加蓬,11,北京市,50795654 ,11366544303 ,11417339957 
266,加蓬,12,天津市,34992847 ,212334181 ,247327028 
266,加蓬,13,河北省,98948349 ,352367093 ,451315442 
266,加蓬,14,山西省,302109 ,73498124 ,73800233 
266,加蓬,15,内蒙古自治区,1229845 ,149753545 ,150983390 
266,加蓬,21,辽宁省,7939846 ,739449 ,8679295 
266,加蓬,23,黑龙江省,1658778 ,0 ,1658778 
266,加蓬,31,上海市,86360321 ,1416685262 ,1503045583 
266,加蓬,32,江苏省,171660836 ,1596518538 ,1768179374 
266,加蓬,33,浙江省,636898404 ,612243120 ,1249141524 
266,加蓬,34,安徽省,28453139 ,110048989 ,138502128 
266,加蓬,35,福建省,162764076 ,690088038 ,852852114 
266,加蓬,36,江西省,78040118 ,68793161 ,146833279 
266,加蓬,37,山东省,495500657 ,1032608236 ,1528108893 
266,加蓬,41,河南省,28836672 ,0 ,28836672 
266,加蓬,42,湖北省,105058166 ,0 ,105058166 
266,加蓬,43,湖南省,69711437 ,141476149 ,211187586 
266,加蓬,44,广东省,354631537 ,63013192 ,417644729 
266,加蓬,45,广西壮族自治区,61691357 ,374878092 ,436569449 
266,加蓬,46,海南省,1401392 ,302116367 ,303517759 
266,加蓬,50,重庆市,19810655 ,112392957 ,132203612 
266,加蓬,51,四川省,39812365 ,240927467 ,280739832 
266,加蓬,52,贵州省,0 ,500155459 ,500155459 
266,加蓬,53,云南省,33649856 ,0 ,33649856 
266,加蓬,61,陕西省,54060692 ,2199 ,54062891 
266,加蓬,62,甘肃省,533146 ,23473971 ,24007117 
266,加蓬,64,宁夏回族自治区,0 ,77722187 ,77722187 
266,加蓬,65,新疆维吾尔自治区,2659227 ,0 ,2659227 
268,格鲁吉亚,11,北京市,216731445 ,10983770 ,227715215 
268,格鲁吉亚,12,天津市,71071099 ,1985014 ,73056113 
268,格鲁吉亚,13,河北省,80307454 ,0 ,80307454 
268,格鲁吉亚,14,山西省,4679191 ,0 ,4679191 
268,格鲁吉亚,15,内蒙古自治区,1731271 ,369036 ,2100307 
268,格鲁吉亚,21,辽宁省,32526666 ,406329 ,32932995 
268,格鲁吉亚,22,吉林省,6156505 ,4760 ,6161265 
268,格鲁吉亚,23,黑龙江省,7163304 ,3337468 ,10500772 
268,格鲁吉亚,31,上海市,149197868 ,49987030 ,199184898 
268,格鲁吉亚,32,江苏省,540246306 ,48524194 ,588770500 
268,格鲁吉亚,33,浙江省,1586810227 ,133557503 ,1720367730 
268,格鲁吉亚,34,安徽省,77531456 ,18419282 ,95950738 
268,格鲁吉亚,35,福建省,114539245 ,6504370 ,121043615 
268,格鲁吉亚,36,江西省,66525684 ,173059028 ,239584712 
268,格鲁吉亚,37,山东省,754367996 ,35023508 ,789391504 
268,格鲁吉亚,41,河南省,100167755 ,296083713 ,396251468 
268,格鲁吉亚,42,湖北省,54872104 ,617026 ,55489130 
268,格鲁吉亚,43,湖南省,160164053 ,1457492 ,161621545 
268,格鲁吉亚,44,广东省,920350953 ,71091250 ,991442203 
268,格鲁吉亚,45,广西壮族自治区,27164608 ,5858250 ,33022858 
268,格鲁吉亚,46,海南省,104294710 ,382832 ,104677542 
268,格鲁吉亚,50,重庆市,178225618 ,1523656 ,179749274 
268,格鲁吉亚,51,四川省,94005856 ,1121249 ,95127105 
268,格鲁吉亚,52,贵州省,49191386 ,0 ,49191386 
268,格鲁吉亚,53,云南省,19606017 ,0 ,19606017 
268,格鲁吉亚,61,陕西省,10757150 ,2560276 ,13317426 
268,格鲁吉亚,62,甘肃省,19679834 ,0 ,19679834 
268,格鲁吉亚,63,青海省,1347503 ,0 ,1347503 
268,格鲁吉亚,64,宁夏回族自治区,2272462 ,0 ,2272462 
268,格鲁吉亚,65,新疆维吾尔自治区,50832829 ,3889133 ,54721962 
270,冈比亚,11,北京市,32864055 ,5787 ,32869842 
270,冈比亚,12,天津市,30828275 ,498 ,30828773 
270,冈比亚,13,河北省,69788213 ,0 ,69788213 
270,冈比亚,15,内蒙古自治区,1425695 ,0 ,1425695 
270,冈比亚,21,辽宁省,1200965 ,739 ,1201704 
270,冈比亚,22,吉林省,192 ,0 ,192 
270,冈比亚,23,黑龙江省,3405035 ,0 ,3405035 
270,冈比亚,31,上海市,109222809 ,117604844 ,226827653 
270,冈比亚,32,江苏省,89114547 ,31588759 ,120703306 
270,冈比亚,33,浙江省,671606419 ,20814598 ,692421017 
270,冈比亚,34,安徽省,39593822 ,6030841 ,45624663 
270,冈比亚,35,福建省,50449625 ,17370732 ,67820357 
270,冈比亚,36,江西省,82875366 ,0 ,82875366 
270,冈比亚,37,山东省,520493685 ,529 ,520494214 
270,冈比亚,41,河南省,14022911 ,0 ,14022911 
270,冈比亚,42,湖北省,38756691 ,0 ,38756691 
270,冈比亚,43,湖南省,103855538 ,0 ,103855538 
270,冈比亚,44,广东省,261024613 ,16541905 ,277566518 
270,冈比亚,45,广西壮族自治区,4689596 ,842472 ,5532068 
270,冈比亚,46,海南省,433095 ,32474181 ,32907276 
270,冈比亚,50,重庆市,44648722 ,0 ,44648722 
270,冈比亚,51,四川省,40059887 ,0 ,40059887 
270,冈比亚,52,贵州省,3608214 ,0 ,3608214 
270,冈比亚,53,云南省,17564595 ,0 ,17564595 
270,冈比亚,61,陕西省,5236677 ,0 ,5236677 
270,冈比亚,65,新疆维吾尔自治区,54404005 ,0 ,54404005 
275,巴勒斯坦,11,北京市,1673819 ,59 ,1673878 
275,巴勒斯坦,12,天津市,1350023 ,0 ,1350023 
275,巴勒斯坦,13,河北省,9947112 ,0 ,9947112 
275,巴勒斯坦,14,山西省,465913 ,0 ,465913 
275,巴勒斯坦,15,内蒙古自治区,245565 ,0 ,245565 
275,巴勒斯坦,21,辽宁省,1938745 ,0 ,1938745 
275,巴勒斯坦,23,黑龙江省,257324 ,0 ,257324 
275,巴勒斯坦,31,上海市,17798942 ,48252 ,17847194 
275,巴勒斯坦,32,江苏省,92812370 ,2311 ,92814681 
275,巴勒斯坦,33,浙江省,229890357 ,127 ,229890484 
275,巴勒斯坦,34,安徽省,11807337 ,0 ,11807337 
275,巴勒斯坦,35,福建省,17591338 ,0 ,17591338 
275,巴勒斯坦,36,江西省,7087683 ,0 ,7087683 
275,巴勒斯坦,37,山东省,58061412 ,0 ,58061412 
275,巴勒斯坦,41,河南省,12513016 ,0 ,12513016 
275,巴勒斯坦,42,湖北省,5697052 ,0 ,5697052 
275,巴勒斯坦,43,湖南省,11539953 ,0 ,11539953 
275,巴勒斯坦,44,广东省,202697934 ,60235 ,202758169 
275,巴勒斯坦,45,广西壮族自治区,1015522 ,0 ,1015522 
275,巴勒斯坦,50,重庆市,16313378 ,0 ,16313378 
275,巴勒斯坦,51,四川省,4911677 ,0 ,4911677 
275,巴勒斯坦,52,贵州省,147362 ,0 ,147362 
275,巴勒斯坦,53,云南省,637832 ,0 ,637832 
275,巴勒斯坦,61,陕西省,1983443 ,0 ,1983443 
275,巴勒斯坦,62,甘肃省,28 ,0 ,28 
275,巴勒斯坦,65,新疆维吾尔自治区,231700 ,0 ,231700 
276,德国,11,北京市,8511918222 ,126708221433 ,135220139655 
276,德国,12,天津市,10887299370 ,38648879066 ,49536178436 
276,德国,13,河北省,6837420610 ,2006591310 ,8844011920 
276,德国,14,山西省,1229339943 ,955193854 ,2184533797 
276,德国,15,内蒙古自治区,776790813 ,945479529 ,1722270342 
276,德国,21,辽宁省,11094683235 ,26871424689 ,37966107924 
276,德国,22,吉林省,4264164092 ,19840351910 ,24104516002 
276,德国,23,黑龙江省,870139479 ,1098437096 ,1968576575 
276,德国,31,上海市,48095455233 ,140130144969 ,188225600202 
276,德国,32,江苏省,95394812983 ,70114418167 ,165509231150 
276,德国,33,浙江省,98936359429 ,23637626966 ,122573986395 
276,德国,34,安徽省,11894851245 ,4592679763 ,16487531008 
276,德国,35,福建省,40391558989 ,8079379061 ,48470938050 
276,德国,36,江西省,7862204193 ,940815346 ,8803019539 
276,德国,37,山东省,35125938699 ,13867074966 ,48993013665 
276,德国,41,河南省,8556770030 ,2209673833 ,10766443863 
276,德国,42,湖北省,7571269095 ,4890792472 ,12462061567 
276,德国,43,湖南省,8326046437 ,3694683427 ,12020729864 
276,德国,44,广东省,112931923891 ,49959376915 ,162891300806 
276,德国,45,广西壮族自治区,1633982347 ,620747494 ,2254729841 
276,德国,46,海南省,247887655 ,780181466 ,1028069121 
276,德国,50,重庆市,35537317130 ,3805147720 ,39342464850 
276,德国,51,四川省,14093585041 ,4501708000 ,18595293041 
276,德国,52,贵州省,336730994 ,223367742 ,560098736 
276,德国,53,云南省,1899097036 ,722141398 ,2621238434 
276,德国,54,西藏自治区,215743 ,8437690 ,8653433 
276,德国,61,陕西省,5919987696 ,3510527803 ,9430515499 
276,德国,62,甘肃省,177875142 ,128646525 ,306521667 
276,德国,63,青海省,10759455 ,30047696 ,40807151 
276,德国,64,宁夏回族自治区,1132675978 ,296572659 ,1429248637 
276,德国,65,新疆维吾尔自治区,1198177882 ,540813562 ,1738991444 
288,加纳,11,北京市,350732888 ,8801997793 ,9152730681 
288,加纳,12,天津市,617943257 ,11864651 ,629807908 
288,加纳,13,河北省,1015194302 ,80548940 ,1095743242 
288,加纳,14,山西省,53289513 ,1804322 ,55093835 
288,加纳,15,内蒙古自治区,98755979 ,0 ,98755979 
288,加纳,21,辽宁省,231991150 ,1775 ,231992925 
288,加纳,22,吉林省,39141669 ,0 ,39141669 
288,加纳,23,黑龙江省,35979644 ,4526655 ,40506299 
288,加纳,31,上海市,939266017 ,1528133896 ,2467399913 
288,加纳,32,江苏省,3418299235 ,27955377 ,3446254612 
288,加纳,33,浙江省,9005765547 ,409308854 ,9415074401 
288,加纳,34,安徽省,1126648898 ,46223961 ,1172872859 
288,加纳,35,福建省,2502479652 ,4551045 ,2507030697 
288,加纳,36,江西省,1400193722 ,5681079 ,1405874801 
288,加纳,37,山东省,5065354269 ,18375997 ,5083730266 
288,加纳,41,河南省,1152633935 ,13077784 ,1165711719 
288,加纳,42,湖北省,1265481832 ,4504 ,1265486336 
288,加纳,43,湖南省,1766564721 ,4015918 ,1770580639 
288,加纳,44,广东省,7099125245 ,66903433 ,7166028678 
288,加纳,45,广西壮族自治区,343099478 ,0 ,343099478 
288,加纳,46,海南省,129032848 ,14036806 ,143069654 
288,加纳,50,重庆市,503297556 ,675 ,503298231 
288,加纳,51,四川省,713338827 ,9001 ,713347828 
288,加纳,52,贵州省,60456903 ,0 ,60456903 
288,加纳,53,云南省,286510936 ,0 ,286510936 
288,加纳,61,陕西省,127673259 ,5298798 ,132972057 
288,加纳,62,甘肃省,21999924 ,2628 ,22002552 
288,加纳,63,青海省,8137811 ,0 ,8137811 
288,加纳,64,宁夏回族自治区,13153290 ,1054713436 ,1067866726 
288,加纳,65,新疆维吾尔自治区,270423779 ,0 ,270423779 
292,直布罗陀,11,北京市,3163226 ,1672 ,3164898 
292,直布罗陀,12,天津市,2859915 ,0 ,2859915 
292,直布罗陀,13,河北省,70660 ,0 ,70660 
292,直布罗陀,15,内蒙古自治区,641 ,0 ,641 
292,直布罗陀,21,辽宁省,47 ,0 ,47 
292,直布罗陀,31,上海市,886418 ,2420 ,888838 
292,直布罗陀,32,江苏省,407015 ,75928 ,482943 
292,直布罗陀,33,浙江省,10881401 ,0 ,10881401 
292,直布罗陀,34,安徽省,3232 ,0 ,3232 
292,直布罗陀,35,福建省,3521 ,0 ,3521 
292,直布罗陀,36,江西省,486000 ,0 ,486000 
292,直布罗陀,37,山东省,128687 ,1076 ,129763 
292,直布罗陀,41,河南省,3665 ,0 ,3665 
292,直布罗陀,42,湖北省,51241 ,0 ,51241 
292,直布罗陀,43,湖南省,339574 ,0 ,339574 
292,直布罗陀,44,广东省,11280334 ,30680 ,11311014 
292,直布罗陀,45,广西壮族自治区,19545 ,0 ,19545 
292,直布罗陀,51,四川省,129142 ,64 ,129206 
292,直布罗陀,52,贵州省,39 ,0 ,39 
292,直布罗陀,61,陕西省,117 ,0 ,117 
296,基里巴斯,11,北京市,15971985 ,449 ,15972434 
296,基里巴斯,12,天津市,686935 ,0 ,686935 
296,基里巴斯,13,河北省,4492526 ,0 ,4492526 
296,基里巴斯,15,内蒙古自治区,1088 ,0 ,1088 
296,基里巴斯,21,辽宁省,46301 ,0 ,46301 
296,基里巴斯,23,黑龙江省,634964 ,0 ,634964 
296,基里巴斯,31,上海市,1776052 ,71 ,1776123 
296,基里巴斯,32,江苏省,9548664 ,0 ,9548664 
296,基里巴斯,33,浙江省,35588189 ,0 ,35588189 
296,基里巴斯,34,安徽省,3711389 ,0 ,3711389 
296,基里巴斯,35,福建省,12043782 ,0 ,12043782 
296,基里巴斯,36,江西省,4469255 ,0 ,4469255 
296,基里巴斯,37,山东省,23002620 ,2942 ,23005562 
296,基里巴斯,41,河南省,1625758 ,0 ,1625758 
296,基里巴斯,42,湖北省,6530474 ,0 ,6530474 
296,基里巴斯,43,湖南省,5489704 ,0 ,5489704 
296,基里巴斯,44,广东省,35942788 ,1270 ,35944058 
296,基里巴斯,45,广西壮族自治区,137030 ,0 ,137030 
296,基里巴斯,50,重庆市,7972477 ,0 ,7972477 
296,基里巴斯,51,四川省,4494752 ,0 ,4494752 
300,希腊,11,北京市,747532153 ,501229549 ,1248761702 
300,希腊,12,天津市,737168573 ,19518045 ,756686618 
300,希腊,13,河北省,699225419 ,2581030 ,701806449 
300,希腊,14,山西省,21095921 ,68182 ,21164103 
300,希腊,15,内蒙古自治区,141694707 ,1559 ,141696266 
300,希腊,21,辽宁省,500448950 ,14938086 ,515387036 
300,希腊,22,吉林省,89031440 ,7145 ,89038585 
300,希腊,23,黑龙江省,71961164 ,300 ,71961464 
300,希腊,31,上海市,2119080268 ,809073669 ,2928153937 
300,希腊,32,江苏省,6326326100 ,123018625 ,6449344725 
300,希腊,33,浙江省,19064437169 ,211126823 ,19275563992 
300,希腊,34,安徽省,961175001 ,64792117 ,1025967118 
300,希腊,35,福建省,5406464171 ,513542574 ,5920006745 
300,希腊,36,江西省,2358462113 ,1688 ,2358463801 
300,希腊,37,山东省,3357738562 ,345543559 ,3703282121 
300,希腊,41,河南省,495872617 ,155843324 ,651715941 
300,希腊,42,湖北省,1082904073 ,555524 ,1083459597 
300,希腊,43,湖南省,2589229998 ,17451271 ,2606681269 
300,希腊,44,广东省,13299523536 ,933209865 ,14232733401 
300,希腊,45,广西壮族自治区,292623018 ,507495 ,293130513 
300,希腊,46,海南省,32579682 ,2897136 ,35476818 
300,希腊,50,重庆市,3235544860 ,202214 ,3235747074 
300,希腊,51,四川省,649805095 ,3063702 ,652868797 
300,希腊,52,贵州省,127930979 ,0 ,127930979 
300,希腊,53,云南省,407418559 ,3187231 ,410605790 
300,希腊,54,西藏自治区,1831873 ,0 ,1831873 
300,希腊,61,陕西省,680435951 ,718100 ,681154051 
300,希腊,62,甘肃省,6908931 ,0 ,6908931 
300,希腊,63,青海省,6895099 ,0 ,6895099 
300,希腊,64,宁夏回族自治区,42772799 ,0 ,42772799 
300,希腊,65,新疆维吾尔自治区,175029849 ,5047 ,175034896 
304,格陵兰,11,北京市,2435 ,13186827 ,13189262 
304,格陵兰,12,天津市,312 ,59632909 ,59633221 
304,格陵兰,13,河北省,468 ,0 ,468 
304,格陵兰,15,内蒙古自治区,1500 ,0 ,1500 
304,格陵兰,21,辽宁省,16817 ,97093508 ,97110325 
304,格陵兰,23,黑龙江省,0 ,2124869 ,2124869 
304,格陵兰,31,上海市,134895 ,35310899 ,35445794 
304,格陵兰,32,江苏省,230932 ,19875 ,250807 
304,格陵兰,33,浙江省,935666 ,31293728 ,32229394 
304,格陵兰,34,安徽省,30949 ,0 ,30949 
304,格陵兰,35,福建省,7926 ,246404978 ,246412904 
304,格陵兰,36,江西省,1643 ,0 ,1643 
304,格陵兰,37,山东省,1148331 ,700643386 ,701791717 
304,格陵兰,41,河南省,4433 ,0 ,4433 
304,格陵兰,42,湖北省,6307 ,0 ,6307 
304,格陵兰,43,湖南省,3792 ,914825 ,918617 
304,格陵兰,44,广东省,1359286 ,188012363 ,189371649 
304,格陵兰,50,重庆市,39 ,48433065 ,48433104 
304,格陵兰,51,四川省,234 ,0 ,234 
304,格陵兰,52,贵州省,78 ,0 ,78 
304,格陵兰,53,云南省,1346532 ,0 ,1346532 
304,格陵兰,61,陕西省,39 ,0 ,39 
308,格林纳达,11,北京市,3802352 ,44976 ,3847328 
308,格林纳达,12,天津市,14665 ,0 ,14665 
308,格林纳达,13,河北省,5427921 ,0 ,5427921 
308,格林纳达,21,辽宁省,2632145 ,0 ,2632145 
308,格林纳达,31,上海市,3562999 ,1178 ,3564177 
308,格林纳达,32,江苏省,6363448 ,0 ,6363448 
308,格林纳达,33,浙江省,15467363 ,0 ,15467363 
308,格林纳达,34,安徽省,3435851 ,0 ,3435851 
308,格林纳达,35,福建省,8846452 ,0 ,8846452 
308,格林纳达,36,江西省,5885569 ,0 ,5885569 
308,格林纳达,37,山东省,17809806 ,0 ,17809806 
308,格林纳达,41,河南省,2127555 ,0 ,2127555 
308,格林纳达,42,湖北省,2598399 ,0 ,2598399 
308,格林纳达,43,湖南省,7345487 ,0 ,7345487 
308,格林纳达,44,广东省,22870810 ,20000 ,22890810 
308,格林纳达,46,海南省,1583009 ,0 ,1583009 
308,格林纳达,50,重庆市,342896 ,0 ,342896 
308,格林纳达,51,四川省,2215948 ,0 ,2215948 
308,格林纳达,52,贵州省,39 ,0 ,39 
308,格林纳达,53,云南省,1505720 ,0 ,1505720 
308,格林纳达,61,陕西省,119352 ,0 ,119352 
312,瓜德罗普,11,北京市,257898 ,1274 ,259172 
312,瓜德罗普,12,天津市,422807 ,0 ,422807 
312,瓜德罗普,13,河北省,21943138 ,0 ,21943138 
312,瓜德罗普,21,辽宁省,503655 ,0 ,503655 
312,瓜德罗普,31,上海市,13031892 ,12599 ,13044491 
312,瓜德罗普,32,江苏省,28676063 ,315 ,28676378 
312,瓜德罗普,33,浙江省,82520127 ,51 ,82520178 
312,瓜德罗普,34,安徽省,6873220 ,0 ,6873220 
312,瓜德罗普,35,福建省,12662300 ,15175 ,12677475 
312,瓜德罗普,36,江西省,6317996 ,0 ,6317996 
312,瓜德罗普,37,山东省,33574795 ,0 ,33574795 
312,瓜德罗普,41,河南省,7307129 ,0 ,7307129 
312,瓜德罗普,42,湖北省,1023065 ,0 ,1023065 
312,瓜德罗普,43,湖南省,5584685 ,0 ,5584685 
312,瓜德罗普,44,广东省,107637160 ,18104 ,107655264 
312,瓜德罗普,45,广西壮族自治区,1240650 ,0 ,1240650 
312,瓜德罗普,50,重庆市,552451 ,0 ,552451 
312,瓜德罗普,51,四川省,1592190 ,662 ,1592852 
312,瓜德罗普,53,云南省,2363035 ,0 ,2363035 
312,瓜德罗普,61,陕西省,1394806 ,0 ,1394806 
320,危地马拉,11,北京市,422266032 ,23166740 ,445432772 
320,危地马拉,12,天津市,384011444 ,4463734 ,388475178 
320,危地马拉,13,河北省,375550106 ,205458896 ,581009002 
320,危地马拉,14,山西省,50039593 ,562448751 ,612488344 
320,危地马拉,15,内蒙古自治区,192039286 ,0 ,192039286 
320,危地马拉,21,辽宁省,703931102 ,78683 ,704009785 
320,危地马拉,22,吉林省,38162292 ,0 ,38162292 
320,危地马拉,23,黑龙江省,47011092 ,9262 ,47020354 
320,危地马拉,31,上海市,986298530 ,232817539 ,1219116069 
320,危地马拉,32,江苏省,1958146887 ,499859069 ,2458005956 
320,危地马拉,33,浙江省,5849879490 ,248253956 ,6098133446 
320,危地马拉,34,安徽省,469600335 ,19071589 ,488671924 
320,危地马拉,35,福建省,1032899543 ,173944535 ,1206844078 
320,危地马拉,36,江西省,408842363 ,224 ,408842587 
320,危地马拉,37,山东省,2458956256 ,250338316 ,2709294572 
320,危地马拉,41,河南省,570561193 ,1811 ,570563004 
320,危地马拉,42,湖北省,312894181 ,94692 ,312988873 
320,危地马拉,43,湖南省,383888594 ,1463116 ,385351710 
320,危地马拉,44,广东省,3440436487 ,111662253 ,3552098740 
320,危地马拉,45,广西壮族自治区,145776856 ,128430785 ,274207641 
320,危地马拉,46,海南省,37578757 ,496500 ,38075257 
320,危地马拉,50,重庆市,819084471 ,128617 ,819213088 
320,危地马拉,51,四川省,271626111 ,17155559 ,288781670 
320,危地马拉,52,贵州省,30713104 ,0 ,30713104 
320,危地马拉,53,云南省,100365968 ,1795893 ,102161861 
320,危地马拉,54,西藏自治区,1267658 ,0 ,1267658 
320,危地马拉,61,陕西省,43171627 ,254940 ,43426567 
320,危地马拉,62,甘肃省,6421576 ,88 ,6421664 
320,危地马拉,63,青海省,0 ,60810359 ,60810359 
320,危地马拉,64,宁夏回族自治区,33363157 ,0 ,33363157 
320,危地马拉,65,新疆维吾尔自治区,14316866 ,0 ,14316866 
324,几内亚,11,北京市,223420159 ,444936463 ,668356622 
324,几内亚,12,天津市,152046349 ,161435021 ,313481370 
324,几内亚,13,河北省,190130658 ,464163268 ,654293926 
324,几内亚,14,山西省,39248730 ,424530075 ,463778805 
324,几内亚,15,内蒙古自治区,15042691 ,456 ,15043147 
324,几内亚,21,辽宁省,167884144 ,310 ,167884454 
324,几内亚,22,吉林省,1804492 ,0 ,1804492 
324,几内亚,23,黑龙江省,5297893 ,0 ,5297893 
324,几内亚,31,上海市,302452310 ,1162673038 ,1465125348 
324,几内亚,32,江苏省,1254274856 ,305341171 ,1559616027 
324,几内亚,33,浙江省,2579066491 ,220521920 ,2799588411 
324,几内亚,34,安徽省,342638717 ,2935 ,342641652 
324,几内亚,35,福建省,365273291 ,464122000 ,829395291 
324,几内亚,36,江西省,316951270 ,4241 ,316955511 
324,几内亚,37,山东省,2386174154 ,15737686440 ,18123860594 
324,几内亚,41,河南省,81573872 ,4109 ,81577981 
324,几内亚,42,湖北省,238139899 ,692 ,238140591 
324,几内亚,43,湖南省,463681873 ,0 ,463681873 
324,几内亚,44,广东省,1830122245 ,1061587629 ,2891709874 
324,几内亚,45,广西壮族自治区,113490137 ,1254439 ,114744576 
324,几内亚,46,海南省,2117246 ,0 ,2117246 
324,几内亚,50,重庆市,165815566 ,1007048956 ,1172864522 
324,几内亚,51,四川省,180970621 ,516 ,180971137 
324,几内亚,52,贵州省,22466550 ,0 ,22466550 
324,几内亚,53,云南省,58618591 ,0 ,58618591 
324,几内亚,61,陕西省,287559152 ,0 ,287559152 
324,几内亚,62,甘肃省,4696813 ,0 ,4696813 
324,几内亚,63,青海省,809012 ,308435615 ,309244627 
324,几内亚,64,宁夏回族自治区,8632389 ,0 ,8632389 
324,几内亚,65,新疆维吾尔自治区,9216352 ,0 ,9216352 
328,圭亚那,11,北京市,34383746 ,5823558035 ,5857941781 
328,圭亚那,12,天津市,23801377 ,592931 ,24394308 
328,圭亚那,13,河北省,68996779 ,0 ,68996779 
328,圭亚那,14,山西省,1362400 ,0 ,1362400 
328,圭亚那,15,内蒙古自治区,11597698 ,0 ,11597698 
328,圭亚那,21,辽宁省,6073702 ,0 ,6073702 
328,圭亚那,22,吉林省,291689 ,0 ,291689 
328,圭亚那,23,黑龙江省,269912 ,0 ,269912 
328,圭亚那,31,上海市,69720148 ,83175626 ,152895774 
328,圭亚那,32,江苏省,209783885 ,2751794 ,212535679 
328,圭亚那,33,浙江省,626305960 ,6686540 ,632992500 
328,圭亚那,34,安徽省,50322369 ,1200 ,50323569 
328,圭亚那,35,福建省,239250637 ,5231842 ,244482479 
328,圭亚那,36,江西省,100653790 ,430007 ,101083797 
328,圭亚那,37,山东省,450085149 ,9057 ,450094206 
328,圭亚那,41,河南省,23402462 ,0 ,23402462 
328,圭亚那,42,湖北省,73120316 ,0 ,73120316 
328,圭亚那,43,湖南省,187585487 ,10767182 ,198352669 
328,圭亚那,44,广东省,307271878 ,12604357 ,319876235 
328,圭亚那,45,广西壮族自治区,19905811 ,0 ,19905811 
328,圭亚那,46,海南省,101965737 ,0 ,101965737 
328,圭亚那,50,重庆市,44298939 ,40418482 ,84717421 
328,圭亚那,51,四川省,55194951 ,4440 ,55199391 
328,圭亚那,52,贵州省,12798579 ,0 ,12798579 
328,圭亚那,53,云南省,26463551 ,0 ,26463551 
328,圭亚那,61,陕西省,19872049 ,0 ,19872049 
328,圭亚那,62,甘肃省,2703098 ,0 ,2703098 
328,圭亚那,64,宁夏回族自治区,2910651 ,0 ,2910651 
328,圭亚那,65,新疆维吾尔自治区,31343057 ,0 ,31343057 
332,海地,11,北京市,15301029 ,323188 ,15624217 
332,海地,12,天津市,53331146 ,13171 ,53344317 
332,海地,13,河北省,56399704 ,3980 ,56403684 
332,海地,14,山西省,2386053 ,0 ,2386053 
332,海地,15,内蒙古自治区,2184849 ,0 ,2184849 
332,海地,21,辽宁省,40242070 ,60541 ,40302611 
332,海地,22,吉林省,1050102 ,0 ,1050102 
332,海地,23,黑龙江省,11023380 ,0 ,11023380 
332,海地,31,上海市,116641961 ,1714684 ,118356645 
332,海地,32,江苏省,276286066 ,237634 ,276523700 
332,海地,33,浙江省,1023111103 ,3348728 ,1026459831 
332,海地,34,安徽省,54605223 ,33451 ,54638674 
332,海地,35,福建省,283768221 ,57302 ,283825523 
332,海地,36,江西省,101890557 ,0 ,101890557 
332,海地,37,山东省,519471941 ,15740 ,519487681 
332,海地,41,河南省,24429226 ,21758 ,24450984 
332,海地,42,湖北省,50840474 ,2856 ,50843330 
332,海地,43,湖南省,63048022 ,68867 ,63116889 
332,海地,44,广东省,745666668 ,5856525 ,751523193 
332,海地,45,广西壮族自治区,9328366 ,0 ,9328366 
332,海地,46,海南省,0 ,1239 ,1239 
332,海地,50,重庆市,37301951 ,16804 ,37318755 
332,海地,51,四川省,37975312 ,9163 ,37984475 
332,海地,53,云南省,49011810 ,0 ,49011810 
332,海地,61,陕西省,6237387 ,0 ,6237387 
332,海地,64,宁夏回族自治区,2249925 ,0 ,2249925 
332,海地,65,新疆维吾尔自治区,24656031 ,0 ,24656031 
336,梵蒂冈城国,11,北京市,78 ,592 ,670 
336,梵蒂冈城国,12,天津市,39 ,0 ,39 
336,梵蒂冈城国,14,山西省,39 ,0 ,39 
336,梵蒂冈城国,31,上海市,1338 ,13417 ,14755 
336,梵蒂冈城国,32,江苏省,222452 ,0 ,222452 
336,梵蒂冈城国,33,浙江省,209989 ,0 ,209989 
336,梵蒂冈城国,34,安徽省,117 ,0 ,117 
336,梵蒂冈城国,37,山东省,32459 ,0 ,32459 
336,梵蒂冈城国,41,河南省,39 ,0 ,39 
336,梵蒂冈城国,44,广东省,4799 ,5791 ,10590 
336,梵蒂冈城国,52,贵州省,39 ,0 ,39 
340,洪都拉斯,11,北京市,96128732 ,4345771 ,100474503 
340,洪都拉斯,12,天津市,503074317 ,34388 ,503108705 
340,洪都拉斯,13,河北省,150195624 ,284026 ,150479650 
340,洪都拉斯,14,山西省,3632243 ,0 ,3632243 
340,洪都拉斯,15,内蒙古自治区,24534932 ,0 ,24534932 
340,洪都拉斯,21,辽宁省,161776835 ,252868 ,162029703 
340,洪都拉斯,22,吉林省,9330094 ,0 ,9330094 
340,洪都拉斯,23,黑龙江省,25994656 ,5118 ,25999774 
340,洪都拉斯,31,上海市,456018149 ,22641238 ,478659387 
340,洪都拉斯,32,江苏省,769029234 ,33132676 ,802161910 
340,洪都拉斯,33,浙江省,1700572716 ,49525564 ,1750098280 
340,洪都拉斯,34,安徽省,120797777 ,12956098 ,133753875 
340,洪都拉斯,35,福建省,619492953 ,4814258 ,624307211 
340,洪都拉斯,36,江西省,149460221 ,74677 ,149534898 
340,洪都拉斯,37,山东省,1239057731 ,125923 ,1239183654 
340,洪都拉斯,41,河南省,65962822 ,6151732 ,72114554 
340,洪都拉斯,42,湖北省,89413843 ,640263 ,90054106 
340,洪都拉斯,43,湖南省,116025094 ,1063801 ,117088895 
340,洪都拉斯,44,广东省,1087027209 ,18079888 ,1105107097 
340,洪都拉斯,45,广西壮族自治区,61763325 ,0 ,61763325 
340,洪都拉斯,46,海南省,7713461 ,6519 ,7719980 
340,洪都拉斯,50,重庆市,374942067 ,8071 ,374950138 
340,洪都拉斯,51,四川省,80115561 ,267144 ,80382705 
340,洪都拉斯,52,贵州省,6455979 ,0 ,6455979 
340,洪都拉斯,53,云南省,20760574 ,0 ,20760574 
340,洪都拉斯,61,陕西省,12311294 ,7172 ,12318466 
340,洪都拉斯,62,甘肃省,282742 ,0 ,282742 
340,洪都拉斯,63,青海省,0 ,374 ,374 
340,洪都拉斯,64,宁夏回族自治区,3001103 ,0 ,3001103 
340,洪都拉斯,65,新疆维吾尔自治区,5747200 ,0 ,5747200 
344,中国香港,11,北京市,48508987724 ,4310970189 ,52819957913 
344,中国香港,12,天津市,16345971389 ,200645671 ,16546617060 
344,中国香港,13,河北省,3992580260 ,42386617 ,4034966877 
344,中国香港,14,山西省,1735452402 ,121602 ,1735574004 
344,中国香港,15,内蒙古自治区,1418152254 ,4395285 ,1422547539 
344,中国香港,21,辽宁省,6961521562 ,319012777 ,7280534339 
344,中国香港,22,吉林省,209716758 ,2254942 ,211971700 
344,中国香港,23,黑龙江省,166122800 ,9649652 ,175772452 
344,中国香港,31,上海市,96457509795 ,8495661620 ,104953171415 
344,中国香港,32,江苏省,147208432446 ,588170428 ,147796602874 
344,中国香港,33,浙江省,38153098712 ,1470678555 ,39623777267 
344,中国香港,34,安徽省,16878042514 ,352247216 ,17230289730 
344,中国香港,35,福建省,36905447991 ,733921380 ,37639369371 
344,中国香港,36,江西省,28639983567 ,404750756 ,29044734323 
344,中国香港,37,山东省,37806928506 ,346134425 ,38153062931 
344,中国香港,41,河南省,19556402783 ,71851374 ,19628254157 
344,中国香港,42,湖北省,27889817702 ,105328730 ,27995146432 
344,中国香港,43,湖南省,40384937059 ,1304608919 ,41689545978 
344,中国香港,44,广东省,716671578937 ,12872196258 ,729543775195 
344,中国香港,45,广西壮族自治区,28682277501 ,1908831780 ,30591109281 
344,中国香港,46,海南省,5582796977 ,630062723 ,6212859700 
344,中国香港,50,重庆市,43501647985 ,67614755 ,43569262740 
344,中国香港,51,四川省,27187684704 ,1735670486 ,28923355190 
344,中国香港,52,贵州省,6104047672 ,14705076 ,6118752748 
344,中国香港,53,云南省,8360749759 ,83248202 ,8443997961 
344,中国香港,54,西藏自治区,14226683 ,5112707 ,19339390 
344,中国香港,61,陕西省,26159161327 ,92089150 ,26251250477 
344,中国香港,62,甘肃省,2109898742 ,157660719 ,2267559461 
344,中国香港,63,青海省,59772912 ,0 ,59772912 
344,中国香港,64,宁夏回族自治区,226670713 ,0 ,226670713 
344,中国香港,65,新疆维吾尔自治区,1246506004 ,13117483 ,1259623487 
348,匈牙利,11,北京市,1090889619 ,6328390152 ,7419279771 
348,匈牙利,12,天津市,1482914882 ,665194108 ,2148108990 
348,匈牙利,13,河北省,404684919 ,19469378 ,424154297 
348,匈牙利,14,山西省,15043479 ,253224 ,15296703 
348,匈牙利,15,内蒙古自治区,81758483 ,185431 ,81943914 
348,匈牙利,21,辽宁省,719588263 ,3020977104 ,3740565367 
348,匈牙利,22,吉林省,72111358 ,2539001763 ,2611113121 
348,匈牙利,23,黑龙江省,18048624 ,61970971 ,80019595 
348,匈牙利,31,上海市,1889844483 ,4223926740 ,6113771223 
348,匈牙利,32,江苏省,9272795757 ,2482662155 ,11755457912 
348,匈牙利,33,浙江省,6842527289 ,982458243 ,7824985532 
348,匈牙利,34,安徽省,727357609 ,51842698 ,779200307 
348,匈牙利,35,福建省,1845745993 ,466043377 ,2311789370 
348,匈牙利,36,江西省,644422026 ,29663686 ,674085712 
348,匈牙利,37,山东省,1591944608 ,550822619 ,2142767227 
348,匈牙利,41,河南省,1573033242 ,34771875 ,1607805117 
348,匈牙利,42,湖北省,431600961 ,155758723 ,587359684 
348,匈牙利,43,湖南省,359563275 ,119528506 ,479091781 
348,匈牙利,44,广东省,18902725990 ,2811782586 ,21714508576 
348,匈牙利,45,广西壮族自治区,44401260 ,10870554 ,55271814 
348,匈牙利,46,海南省,4914127 ,17462438 ,22376565 
348,匈牙利,50,重庆市,1604444656 ,61015725 ,1665460381 
348,匈牙利,51,四川省,973317160 ,245438788 ,1218755948 
348,匈牙利,52,贵州省,25359709 ,40930 ,25400639 
348,匈牙利,53,云南省,10914349 ,534332 ,11448681 
348,匈牙利,54,西藏自治区,53 ,8905 ,8958 
348,匈牙利,61,陕西省,599330789 ,134962207 ,734292996 
348,匈牙利,62,甘肃省,4789671 ,447107 ,5236778 
348,匈牙利,63,青海省,1135 ,0 ,1135 
348,匈牙利,64,宁夏回族自治区,18107900 ,2500337 ,20608237 
348,匈牙利,65,新疆维吾尔自治区,234139861 ,100989 ,234240850 
352,冰岛,11,北京市,3764523 ,27973681 ,31738204 
352,冰岛,12,天津市,9169848 ,12585973 ,21755821 
352,冰岛,13,河北省,12633252 ,5027 ,12638279 
352,冰岛,14,山西省,20408495 ,0 ,20408495 
352,冰岛,15,内蒙古自治区,31575 ,0 ,31575 
352,冰岛,21,辽宁省,7495901 ,113835562 ,121331463 
352,冰岛,22,吉林省,534141 ,1914 ,536055 
352,冰岛,23,黑龙江省,710975 ,5454379 ,6165354 
352,冰岛,31,上海市,31267682 ,87693093 ,118960775 
352,冰岛,32,江苏省,284089474 ,23257733 ,307347207 
352,冰岛,33,浙江省,253265668 ,14339404 ,267605072 
352,冰岛,34,安徽省,49322186 ,164561 ,49486747 
352,冰岛,35,福建省,36681828 ,215480274 ,252162102 
352,冰岛,36,江西省,12794812 ,110634 ,12905446 
352,冰岛,37,山东省,543375081 ,301208775 ,844583856 
352,冰岛,41,河南省,2366760 ,1478 ,2368238 
352,冰岛,42,湖北省,17450884 ,73299 ,17524183 
352,冰岛,43,湖南省,5553544 ,4497 ,5558041 
352,冰岛,44,广东省,220965759 ,58641107 ,279606866 
352,冰岛,45,广西壮族自治区,66669411 ,0 ,66669411 
352,冰岛,46,海南省,2828251 ,0 ,2828251 
352,冰岛,50,重庆市,13559482 ,2282444 ,15841926 
352,冰岛,51,四川省,5221251 ,13469419 ,18690670 
352,冰岛,52,贵州省,3426632 ,0 ,3426632 
352,冰岛,53,云南省,7 ,153205 ,153212 
352,冰岛,54,西藏自治区,196 ,0 ,196 
352,冰岛,61,陕西省,3343605 ,8180 ,3351785 
352,冰岛,62,甘肃省,46782 ,0 ,46782 
352,冰岛,63,青海省,78 ,0 ,78 
356,印度,11,北京市,7828043289 ,4832239266 ,12660282555 
356,印度,12,天津市,8595759207 ,2588169083 ,11183928290 
356,印度,13,河北省,10122190259 ,2516592321 ,12638782580 
356,印度,14,山西省,3605201381 ,432924272 ,4038125653 
356,印度,15,内蒙古自治区,2729608252 ,110429962 ,2840038214 
356,印度,21,辽宁省,9803868975 ,1112865994 ,10916734969 
356,印度,22,吉林省,1799672986 ,142090354 ,1941763340 
356,印度,23,黑龙江省,1218785756 ,94626090 ,1313411846 
356,印度,31,上海市,33674233764 ,19835675795 ,53509909559 
356,印度,32,江苏省,96314388509 ,11231461548 ,107545850057 
356,印度,33,浙江省,97536633363 ,11816775817 ,109353409180 
356,印度,34,安徽省,13640158871 ,1901515341 ,15541674212 
356,印度,35,福建省,15806061132 ,8656504974 ,24462566106 
356,印度,36,江西省,20286964583 ,257647732 ,20544612315 
356,印度,37,山东省,43067474829 ,6776288711 ,49843763540 
356,印度,41,河南省,10837193571 ,1621744280 ,12458937851 
356,印度,42,湖北省,16470331154 ,1553021502 ,18023352656 
356,印度,43,湖南省,14135072115 ,978331340 ,15113403455 
356,印度,44,广东省,125695732940 ,10768884621 ,136464617561 
356,印度,45,广西壮族自治区,3975479752 ,752399662 ,4727879414 
356,印度,46,海南省,761672374 ,1084526611 ,1846198985 
356,印度,50,重庆市,18401038654 ,440815897 ,18841854551 
356,印度,51,四川省,15506228517 ,500330565 ,16006559082 
356,印度,52,贵州省,1453750199 ,369170947 ,1822921146 
356,印度,53,云南省,6005120928 ,496922089 ,6502043017 
356,印度,54,西藏自治区,11475051 ,4742977 ,16218028 
356,印度,61,陕西省,4534906453 ,334340210 ,4869246663 
356,印度,62,甘肃省,380937619 ,18335070 ,399272689 
356,印度,63,青海省,57375976 ,1950237 ,59326213 
356,印度,64,宁夏回族自治区,1441484363 ,3359531 ,1444843894 
356,印度,65,新疆维吾尔自治区,1326049065 ,67598279 ,1393647344 
360,印度尼西亚,11,北京市,9937103714 ,31472780772 ,41409884486 
360,印度尼西亚,12,天津市,9481723937 ,5586849699 ,15068573636 
360,印度尼西亚,13,河北省,5878272841 ,4541218121 ,10419490962 
360,印度尼西亚,14,山西省,1331114722 ,3126481552 ,4457596274 
360,印度尼西亚,15,内蒙古自治区,1461125696 ,342408584 ,1803534280 
360,印度尼西亚,21,辽宁省,4054231218 ,1641529425 ,5695760643 
360,印度尼西亚,22,吉林省,800060937 ,300835760 ,1100896697 
360,印度尼西亚,23,黑龙江省,769358920 ,143724273 ,913083193 
360,印度尼西亚,31,上海市,24661261152 ,54165534591 ,78826795743 
360,印度尼西亚,32,江苏省,48117909197 ,44449729839 ,92567639036 
360,印度尼西亚,33,浙江省,64847947800 ,45438577974 ,110286525774 
360,印度尼西亚,34,安徽省,5821637651 ,6273018090 ,12094655741 
360,印度尼西亚,35,福建省,18850425617 ,67099004250 ,85949429867 
360,印度尼西亚,36,江西省,8490608884 ,3799137424 ,12289746308 
360,印度尼西亚,37,山东省,31989320568 ,19166454534 ,51155775102 
360,印度尼西亚,41,河南省,2977641109 ,2053350251 ,5030991360 
360,印度尼西亚,42,湖北省,7432609043 ,1998380815 ,9430989858 
360,印度尼西亚,43,湖南省,9949949822 ,3660945384 ,13610895206 
360,印度尼西亚,44,广东省,70555411740 ,43746343133 ,114301754873 
360,印度尼西亚,45,广西壮族自治区,3528938526 ,6787499067 ,10316437593 
360,印度尼西亚,46,海南省,2715528713 ,4738968407 ,7454497120 
360,印度尼西亚,50,重庆市,7999966272 ,2720163005 ,10720129277 
360,印度尼西亚,51,四川省,4568297555 ,3715445016 ,8283742571 
360,印度尼西亚,52,贵州省,1020626727 ,2897088424 ,3917715151 
360,印度尼西亚,53,云南省,3038430356 ,562977589 ,3601407945 
360,印度尼西亚,54,西藏自治区,201840600 ,0 ,201840600 
360,印度尼西亚,61,陕西省,1702454385 ,2514928770 ,4217383155 
360,印度尼西亚,62,甘肃省,286105081 ,2613924540 ,2900029621 
360,印度尼西亚,63,青海省,7364269 ,29001135 ,36365404 
360,印度尼西亚,64,宁夏回族自治区,270426357 ,10959279 ,281385636 
360,印度尼西亚,65,新疆维吾尔自治区,342290936 ,2490830344 ,2833121280 
364,伊朗,11,北京市,2621632125 ,4982064189 ,7603696314 
364,伊朗,12,天津市,534616734 ,2165622640 ,2700239374 
364,伊朗,13,河北省,411079790 ,97829939 ,508909729 
364,伊朗,14,山西省,54687846 ,0 ,54687846 
364,伊朗,15,内蒙古自治区,388399853 ,0 ,388399853 
364,伊朗,21,辽宁省,387074853 ,13403512 ,400478365 
364,伊朗,22,吉林省,10729158 ,0 ,10729158 
364,伊朗,23,黑龙江省,41413877 ,99545 ,41513422 
364,伊朗,31,上海市,4918946204 ,6389620140 ,11308566344 
364,伊朗,32,江苏省,3317126088 ,2641328022 ,5958454110 
364,伊朗,33,浙江省,11673277375 ,5635973639 ,17309251014 
364,伊朗,34,安徽省,6080468883 ,3168937889 ,9249406772 
364,伊朗,35,福建省,614718886 ,739618668 ,1354337554 
364,伊朗,36,江西省,756916564 ,33978 ,756950542 
364,伊朗,37,山东省,2532862235 ,1721826212 ,4254688447 
364,伊朗,41,河南省,132842553 ,17544580 ,150387133 
364,伊朗,42,湖北省,1059029892 ,25947238 ,1084977130 
364,伊朗,43,湖南省,881915689 ,21791443 ,903707132 
364,伊朗,44,广东省,6326135616 ,5156241986 ,11482377602 
364,伊朗,45,广西壮族自治区,211026347 ,0 ,211026347 
364,伊朗,46,海南省,1038204052 ,2192279746 ,3230483798 
364,伊朗,50,重庆市,480082282 ,204366 ,480286648 
364,伊朗,51,四川省,630735831 ,6506563 ,637242394 
364,伊朗,52,贵州省,19799399 ,10672082 ,30471481 
364,伊朗,53,云南省,115189082 ,3770080 ,118959162 
364,伊朗,54,西藏自治区,156 ,0 ,156 
364,伊朗,61,陕西省,339099555 ,515 ,339100070 
364,伊朗,62,甘肃省,9492501 ,0 ,9492501 
364,伊朗,63,青海省,2217026 ,5552227 ,7769253 
364,伊朗,64,宁夏回族自治区,870672 ,10530 ,881202 
364,伊朗,65,新疆维吾尔自治区,60996843 ,2576279 ,63573122 
368,伊拉克,11,北京市,1974944276 ,135665565972 ,137640510248 
368,伊拉克,12,天津市,1440908240 ,216792 ,1441125032 
368,伊拉克,13,河北省,1841023067 ,14337 ,1841037404 
368,伊拉克,14,山西省,43005882 ,0 ,43005882 
368,伊拉克,15,内蒙古自治区,401652435 ,0 ,401652435 
368,伊拉克,21,辽宁省,335880755 ,14393573746 ,14729454501 
368,伊拉克,22,吉林省,48204350 ,0 ,48204350 
368,伊拉克,23,黑龙江省,177048926 ,2897298855 ,3074347781 
368,伊拉克,31,上海市,1063666822 ,127328064 ,1190994886 
368,伊拉克,32,江苏省,3755099267 ,73636889 ,3828736156 
368,伊拉克,33,浙江省,20836526089 ,20254934192 ,41091460281 
368,伊拉克,34,安徽省,1575564308 ,3783 ,1575568091 
368,伊拉克,35,福建省,3141396795 ,2281587897 ,5422984692 
368,伊拉克,36,江西省,2038883770 ,579 ,2038884349 
368,伊拉克,37,山东省,6715835428 ,6628370249 ,13344205677 
368,伊拉克,41,河南省,474460459 ,2542 ,474463001 
368,伊拉克,42,湖北省,1301943982 ,2668 ,1301946650 
368,伊拉克,43,湖南省,2284859051 ,2203 ,2284861254 
368,伊拉克,44,广东省,11487761065 ,1194798586 ,12682559651 
368,伊拉克,45,广西壮族自治区,495101903 ,2157674157 ,2652776060 
368,伊拉克,46,海南省,114778074 ,358718748 ,473496822 
368,伊拉克,50,重庆市,806635292 ,3622227 ,810257519 
368,伊拉克,51,四川省,1197332152 ,276502 ,1197608654 
368,伊拉克,52,贵州省,94765712 ,0 ,94765712 
368,伊拉克,53,云南省,598419476 ,3376199086 ,3974618562 
368,伊拉克,61,陕西省,185589211 ,0 ,185589211 
368,伊拉克,62,甘肃省,33228528 ,1230741 ,34459269 
368,伊拉克,63,青海省,3182261 ,0 ,3182261 
368,伊拉克,64,宁夏回族自治区,17031912 ,0 ,17031912 
368,伊拉克,65,新疆维吾尔自治区,164338582 ,0 ,164338582 
372,爱尔兰,11,北京市,168410792 ,24609949816 ,24778360608 
372,爱尔兰,12,天津市,3180314243 ,645823384 ,3826137627 
372,爱尔兰,13,河北省,307797919 ,135815685 ,443613604 
372,爱尔兰,14,山西省,16603931 ,19593497 ,36197428 
372,爱尔兰,15,内蒙古自治区,26327160 ,8427242 ,34754402 
372,爱尔兰,21,辽宁省,151762438 ,5031125340 ,5182887778 
372,爱尔兰,22,吉林省,1265890158 ,298884170 ,1564774328 
372,爱尔兰,23,黑龙江省,21858871 ,25954685 ,47813556 
372,爱尔兰,31,上海市,2970118319 ,12473457951 ,15443576270 
372,爱尔兰,32,江苏省,3339359894 ,1365967586 ,4705327480 
372,爱尔兰,33,浙江省,4127705234 ,1321505425 ,5449210659 
372,爱尔兰,34,安徽省,460067745 ,136082422 ,596150167 
372,爱尔兰,35,福建省,922033467 ,390011778 ,1312045245 
372,爱尔兰,36,江西省,251494049 ,11603921 ,263097970 
372,爱尔兰,37,山东省,1448403427 ,350412742 ,1798816169 
372,爱尔兰,41,河南省,299230471 ,93415726 ,392646197 
372,爱尔兰,42,湖北省,187562741 ,250909556 ,438472297 
372,爱尔兰,43,湖南省,136648774 ,50878283 ,187527057 
372,爱尔兰,44,广东省,5503104642 ,3459781411 ,8962886053 
372,爱尔兰,45,广西壮族自治区,39601750 ,2520390 ,42122140 
372,爱尔兰,46,海南省,1221228 ,16247024 ,17468252 
372,爱尔兰,50,重庆市,868881174 ,6073836526 ,6942717700 
372,爱尔兰,51,四川省,457797204 ,37120294237 ,37578091441 
372,爱尔兰,52,贵州省,30689522 ,1383349 ,32072871 
372,爱尔兰,53,云南省,23317358 ,0 ,23317358 
372,爱尔兰,54,西藏自治区,515 ,0 ,515 
372,爱尔兰,61,陕西省,756742908 ,584609436 ,1341352344 
372,爱尔兰,62,甘肃省,2812877 ,44236825 ,47049702 
372,爱尔兰,64,宁夏回族自治区,2982249 ,30800 ,3013049 
372,爱尔兰,65,新疆维吾尔自治区,1187237 ,28511425 ,29698662 
376,以色列,11,北京市,1112493268 ,4233857040 ,5346350308 
376,以色列,12,天津市,996690612 ,667956979 ,1664647591 
376,以色列,13,河北省,1587302608 ,188049658 ,1775352266 
376,以色列,14,山西省,75122138 ,3437904 ,78560042 
376,以色列,15,内蒙古自治区,236032723 ,6095 ,236038818 
376,以色列,21,辽宁省,678884914 ,322120080 ,1001004994 
376,以色列,22,吉林省,156764890 ,102685679 ,259450569 
376,以色列,23,黑龙江省,98500495 ,14775685 ,113276180 
376,以色列,31,上海市,5262088981 ,4153894593 ,9415983574 
376,以色列,32,江苏省,9371462859 ,3967060258 ,13338523117 
376,以色列,33,浙江省,16897720388 ,1259702180 ,18157422568 
376,以色列,34,安徽省,1908126245 ,792740923 ,2700867168 
376,以色列,35,福建省,4192379086 ,414472591 ,4606851677 
376,以色列,36,江西省,2210278012 ,59872599 ,2270150611 
376,以色列,37,山东省,6627974320 ,2060444645 ,8688418965 
376,以色列,41,河南省,1812807135 ,102334859 ,1915141994 
376,以色列,42,湖北省,1037055981 ,1789703703 ,2826759684 
376,以色列,43,湖南省,1947709432 ,353845720 ,2301555152 
376,以色列,44,广东省,18479110127 ,3334150744 ,21813260871 
376,以色列,45,广西壮族自治区,264083539 ,87552823 ,351636362 
376,以色列,46,海南省,335602063 ,37460927 ,373062990 
376,以色列,50,重庆市,773719865 ,238078687 ,1011798552 
376,以色列,51,四川省,1756627599 ,20908867297 ,22665494896 
376,以色列,52,贵州省,88544266 ,4442270 ,92986536 
376,以色列,53,云南省,595371624 ,19282605 ,614654229 
376,以色列,61,陕西省,692210755 ,189206175 ,881416930 
376,以色列,62,甘肃省,19748696 ,529224 ,20277920 
376,以色列,63,青海省,12378415 ,0 ,12378415 
376,以色列,64,宁夏回族自治区,86146331 ,21307413 ,107453744 
376,以色列,65,新疆维吾尔自治区,160741133 ,5457416 ,166198549 
380,意大利,11,北京市,5530987034 ,12759092814 ,18290079848 
380,意大利,12,天津市,4136469528 ,4501787529 ,8638257057 
380,意大利,13,河北省,5242950622 ,714662281 ,5957612903 
380,意大利,14,山西省,2546104357 ,217893561 ,2763997918 
380,意大利,15,内蒙古自治区,714523697 ,431442912 ,1145966609 
380,意大利,21,辽宁省,4125083528 ,1995684259 ,6120767787 
380,意大利,22,吉林省,512394583 ,655418856 ,1167813439 
380,意大利,23,黑龙江省,331653349 ,375110591 ,706763940 
380,意大利,31,上海市,19013368794 ,61453005901 ,80466374695 
380,意大利,32,江苏省,37693867303 ,12352581173 ,50046448476 
380,意大利,33,浙江省,51616830002 ,9034285568 ,60651115570 
380,意大利,34,安徽省,6310508035 ,927475382 ,7237983417 
380,意大利,35,福建省,12905267752 ,2860076807 ,15765344559 
380,意大利,36,江西省,3461281920 ,279755990 ,3741037910 
380,意大利,37,山东省,17621886218 ,4323123742 ,21945009960 
380,意大利,41,河南省,8461165303 ,511623247 ,8972788550 
380,意大利,42,湖北省,4962799260 ,852547493 ,5815346753 
380,意大利,43,湖南省,3446469497 ,392116604 ,3838586101 
380,意大利,44,广东省,60071093079 ,14586465033 ,74657558112 
380,意大利,45,广西壮族自治区,926345452 ,179123956 ,1105469408 
380,意大利,46,海南省,325974326 ,2991819562 ,3317793888 
380,意大利,50,重庆市,3186389631 ,921369417 ,4107759048 
380,意大利,51,四川省,2763176322 ,1832293291 ,4595469613 
380,意大利,52,贵州省,274357830 ,23532872 ,297890702 
380,意大利,53,云南省,945648993 ,51267733 ,996916726 
380,意大利,54,西藏自治区,31369951 ,1763329 ,33133280 
380,意大利,61,陕西省,1475334945 ,812241068 ,2287576013 
380,意大利,62,甘肃省,193419516 ,51580863 ,245000379 
380,意大利,63,青海省,31441846 ,5412236 ,36854082 
380,意大利,64,宁夏回族自治区,210770577 ,70158353 ,280928930 
380,意大利,65,新疆维吾尔自治区,901787569 ,83223827 ,985011396 
384,科特迪瓦,11,北京市,710850262 ,234478044 ,945328306 
384,科特迪瓦,12,天津市,229492477 ,53405165 ,282897642 
384,科特迪瓦,13,河北省,309804962 ,1052 ,309806014 
384,科特迪瓦,14,山西省,3075414 ,525 ,3075939 
384,科特迪瓦,15,内蒙古自治区,95062240 ,0 ,95062240 
384,科特迪瓦,21,辽宁省,54257232 ,29371540 ,83628772 
384,科特迪瓦,22,吉林省,48013859 ,0 ,48013859 
384,科特迪瓦,23,黑龙江省,19396738 ,3315 ,19400053 
384,科特迪瓦,31,上海市,1061528570 ,153346523 ,1214875093 
384,科特迪瓦,32,江苏省,1294757562 ,24825587 ,1319583149 
384,科特迪瓦,33,浙江省,3504375375 ,855548659 ,4359924034 
384,科特迪瓦,34,安徽省,392615523 ,25722172 ,418337695 
384,科特迪瓦,35,福建省,810372008 ,175463908 ,985835916 
384,科特迪瓦,36,江西省,419533149 ,390 ,419533539 
384,科特迪瓦,37,山东省,1788023427 ,1486009078 ,3274032505 
384,科特迪瓦,41,河南省,256627754 ,26183 ,256653937 
384,科特迪瓦,42,湖北省,532464858 ,2254288 ,534719146 
384,科特迪瓦,43,湖南省,538301406 ,116690996 ,654992402 
384,科特迪瓦,44,广东省,3479058804 ,763983383 ,4243042187 
384,科特迪瓦,45,广西壮族自治区,126981747 ,57163722 ,184145469 
384,科特迪瓦,46,海南省,68798523 ,5626184 ,74424707 
384,科特迪瓦,50,重庆市,377272423 ,161551635 ,538824058 
384,科特迪瓦,51,四川省,290095796 ,279578923 ,569674719 
384,科特迪瓦,52,贵州省,33411559 ,30015753 ,63427312 
384,科特迪瓦,53,云南省,89651854 ,0 ,89651854 
384,科特迪瓦,54,西藏自治区,298724 ,0 ,298724 
384,科特迪瓦,61,陕西省,73604846 ,2007434 ,75612280 
384,科特迪瓦,62,甘肃省,13502785 ,0 ,13502785 
384,科特迪瓦,64,宁夏回族自治区,2695931 ,7728645 ,10424576 
384,科特迪瓦,65,新疆维吾尔自治区,78870356 ,0 ,78870356 
388,牙买加,11,北京市,58947828 ,4547107 ,63494935 
388,牙买加,12,天津市,29882899 ,450500 ,30333399 
388,牙买加,13,河北省,121491455 ,0 ,121491455 
388,牙买加,14,山西省,4934497 ,0 ,4934497 
388,牙买加,15,内蒙古自治区,1164323 ,0 ,1164323 
388,牙买加,21,辽宁省,11029635 ,1337 ,11030972 
388,牙买加,22,吉林省,6008285 ,0 ,6008285 
388,牙买加,23,黑龙江省,3833663 ,1527 ,3835190 
388,牙买加,31,上海市,143804217 ,13026855 ,156831072 
388,牙买加,32,江苏省,343201063 ,994080 ,344195143 
388,牙买加,33,浙江省,1184500730 ,6380727 ,1190881457 
388,牙买加,34,安徽省,104537333 ,0 ,104537333 
388,牙买加,35,福建省,259445372 ,20566629 ,280012001 
388,牙买加,36,江西省,173606403 ,84887 ,173691290 
388,牙买加,37,山东省,604628035 ,31945 ,604659980 
388,牙买加,41,河南省,41827565 ,232 ,41827797 
388,牙买加,42,湖北省,82481180 ,70340 ,82551520 
388,牙买加,43,湖南省,131415517 ,629 ,131416146 
388,牙买加,44,广东省,1033374806 ,1415504 ,1034790310 
388,牙买加,45,广西壮族自治区,81697432 ,0 ,81697432 
388,牙买加,46,海南省,23779916 ,0 ,23779916 
388,牙买加,50,重庆市,50869819 ,0 ,50869819 
388,牙买加,51,四川省,63545568 ,7259 ,63552827 
388,牙买加,52,贵州省,14046680 ,0 ,14046680 
388,牙买加,53,云南省,48793607 ,0 ,48793607 
388,牙买加,61,陕西省,60109879 ,0 ,60109879 
388,牙买加,62,甘肃省,2437567 ,0 ,2437567 
388,牙买加,64,宁夏回族自治区,1163462 ,0 ,1163462 
388,牙买加,65,新疆维吾尔自治区,5398606 ,0 ,5398606 
392,日本,11,北京市,17549689752 ,80293405305 ,97843095057 
392,日本,12,天津市,17631453818 ,34216143837 ,51847597655 
392,日本,13,河北省,8794505881 ,4169728337 ,12964234218 
392,日本,14,山西省,4619120599 ,2129331739 ,6748452338 
392,日本,15,内蒙古自治区,2224245604 ,939485870 ,3163731474 
392,日本,21,辽宁省,44192319554 ,23387959025 ,67580278579 
392,日本,22,吉林省,2003225639 ,4623249599 ,6626475238 
392,日本,23,黑龙江省,1129610636 ,1063380069 ,2192990705 
392,日本,31,上海市,97982506117 ,189937190896 ,287919697013 
392,日本,32,江苏省,165998565285 ,160816288939 ,326814854224 
392,日本,33,浙江省,78604083606 ,60858409688 ,139462493294 
392,日本,34,安徽省,13229775988 ,19292321298 ,32522097286 
392,日本,35,福建省,38747733172 ,23435823285 ,62183556457 
392,日本,36,江西省,15796703166 ,7488703510 ,23285406676 
392,日本,37,山东省,113059535563 ,29275958807 ,142335494370 
392,日本,41,河南省,14119464152 ,9260356282 ,23379820434 
392,日本,42,湖北省,9711218316 ,18150167417 ,27861385733 
392,日本,43,湖南省,8926961219 ,5342873568 ,14269834787 
392,日本,44,广东省,148478521567 ,197832865076 ,346311386643 
392,日本,45,广西壮族自治区,3492499605 ,2520194848 ,6012694453 
392,日本,46,海南省,1436160710 ,4756834008 ,6192994718 
392,日本,50,重庆市,11744576487 ,10689886358 ,22434462845 
392,日本,51,四川省,18598988423 ,17574045885 ,36173034308 
392,日本,52,贵州省,1396686473 ,176276286 ,1572962759 
392,日本,53,云南省,2655876926 ,1144602103 ,3800479029 
392,日本,54,西藏自治区,19807549 ,491115 ,20298664 
392,日本,61,陕西省,4535261874 ,13682845820 ,18218107694 
392,日本,62,甘肃省,237771893 ,646209032 ,883980925 
392,日本,63,青海省,245044018 ,52774962 ,297818980 
392,日本,64,宁夏回族自治区,872436649 ,818436346 ,1690872995 
392,日本,65,新疆维吾尔自治区,468051014 ,333313920 ,801364934 
398,哈萨克斯坦,11,北京市,3018497774 ,33223401605 ,36241899379 
398,哈萨克斯坦,12,天津市,754449942 ,333336983 ,1087786925 
398,哈萨克斯坦,13,河北省,935203165 ,76751748 ,1011954913 
398,哈萨克斯坦,14,山西省,183346226 ,173379830 ,356726056 
398,哈萨克斯坦,15,内蒙古自治区,65499073 ,137719784 ,203218857 
398,哈萨克斯坦,21,辽宁省,411992624 ,24397248 ,436389872 
398,哈萨克斯坦,22,吉林省,28142365 ,26059840 ,54202205 
398,哈萨克斯坦,23,黑龙江省,150590530 ,91733583 ,242324113 
398,哈萨克斯坦,31,上海市,1232029196 ,803983339 ,2036012535 
398,哈萨克斯坦,32,江苏省,4294937892 ,1450053256 ,5744991148 
398,哈萨克斯坦,33,浙江省,6109531558 ,2499581028 ,8609112586 
398,哈萨克斯坦,34,安徽省,1526157321 ,8315550 ,1534472871 
398,哈萨克斯坦,35,福建省,921977276 ,1832578307 ,2754555583 
398,哈萨克斯坦,36,江西省,445833045 ,11993640 ,457826685 
398,哈萨克斯坦,37,山东省,5465193053 ,4499132021 ,9964325074 
398,哈萨克斯坦,41,河南省,976436671 ,134822022 ,1111258693 
398,哈萨克斯坦,42,湖北省,453042976 ,2926374 ,455969350 
398,哈萨克斯坦,43,湖南省,1129924254 ,387513792 ,1517438046 
398,哈萨克斯坦,44,广东省,4491376407 ,781549546 ,5272925953 
398,哈萨克斯坦,45,广西壮族自治区,92367440 ,59150089 ,151517529 
398,哈萨克斯坦,46,海南省,50555331 ,21026016 ,71581347 
398,哈萨克斯坦,50,重庆市,532878245 ,1382867356 ,1915745601 
398,哈萨克斯坦,51,四川省,564491390 ,120336542 ,684827932 
398,哈萨克斯坦,52,贵州省,32776323 ,0 ,32776323 
398,哈萨克斯坦,53,云南省,6905611 ,67922401 ,74828012 
398,哈萨克斯坦,54,西藏自治区,858091 ,0 ,858091 
398,哈萨克斯坦,61,陕西省,378750876 ,241188538 ,619939414 
398,哈萨克斯坦,62,甘肃省,124041240 ,10199555913 ,10323597153 
398,哈萨克斯坦,63,青海省,44122159 ,0 ,44122159 
398,哈萨克斯坦,64,宁夏回族自治区,163386327 ,43291769 ,206678096 
398,哈萨克斯坦,65,新疆维吾尔自治区,41301287760 ,17871191059 ,59172478819 
400,约旦,11,北京市,664939755 ,1310554621 ,1975494376 
400,约旦,12,天津市,620219027 ,5090731 ,625309758 
400,约旦,13,河北省,345681238 ,16206267 ,361887505 
400,约旦,14,山西省,51423880 ,19244 ,51443124 
400,约旦,15,内蒙古自治区,77277383 ,0 ,77277383 
400,约旦,21,辽宁省,159887551 ,2970866 ,162858417 
400,约旦,22,吉林省,50942694 ,0 ,50942694 
400,约旦,23,黑龙江省,29234322 ,3888 ,29238210 
400,约旦,31,上海市,1239538177 ,555393849 ,1794932026 
400,约旦,32,江苏省,3322696529 ,570189615 ,3892886144 
400,约旦,33,浙江省,8730116794 ,526336774 ,9256453568 
400,约旦,34,安徽省,437980990 ,12213760 ,450194750 
400,约旦,35,福建省,1685264121 ,31699022 ,1716963143 
400,约旦,36,江西省,669834883 ,7341281 ,677176164 
400,约旦,37,山东省,2285669265 ,214991582 ,2500660847 
400,约旦,41,河南省,410711814 ,946742 ,411658556 
400,约旦,42,湖北省,405779908 ,517453 ,406297361 
400,约旦,43,湖南省,933481664 ,19420 ,933501084 
400,约旦,44,广东省,4427135150 ,371273821 ,4798408971 
400,约旦,45,广西壮族自治区,172176383 ,832087 ,173008470 
400,约旦,46,海南省,104867291 ,0 ,104867291 
400,约旦,50,重庆市,267484293 ,4032 ,267488325 
400,约旦,51,四川省,548583900 ,133295 ,548717195 
400,约旦,52,贵州省,80655207 ,0 ,80655207 
400,约旦,53,云南省,160328122 ,0 ,160328122 
400,约旦,61,陕西省,296378156 ,29456159 ,325834315 
400,约旦,62,甘肃省,25145481 ,15845 ,25161326 
400,约旦,63,青海省,3423340 ,0 ,3423340 
400,约旦,64,宁夏回族自治区,16970178 ,0 ,16970178 
400,约旦,65,新疆维吾尔自治区,39179892 ,0 ,39179892 
404,肯尼亚,11,北京市,799600006 ,15951476 ,815551482 
404,肯尼亚,12,天津市,685642782 ,9548934 ,695191716 
404,肯尼亚,13,河北省,813022546 ,9917969 ,822940515 
404,肯尼亚,14,山西省,90729455 ,0 ,90729455 
404,肯尼亚,15,内蒙古自治区,94211249 ,0 ,94211249 
404,肯尼亚,21,辽宁省,255069169 ,22372524 ,277441693 
404,肯尼亚,22,吉林省,72524738 ,0 ,72524738 
404,肯尼亚,23,黑龙江省,89936806 ,483653 ,90420459 
404,肯尼亚,31,上海市,1449790975 ,28153552 ,1477944527 
404,肯尼亚,32,江苏省,3978304811 ,320194845 ,4298499656 
404,肯尼亚,33,浙江省,9296964089 ,35340411 ,9332304500 
404,肯尼亚,34,安徽省,606047015 ,24238016 ,630285031 
404,肯尼亚,35,福建省,1788512079 ,215578370 ,2004090449 
404,肯尼亚,36,江西省,1344937537 ,49635168 ,1394572705 
404,肯尼亚,37,山东省,5236298272 ,49602038 ,5285900310 
404,肯尼亚,41,河南省,322502213 ,33012942 ,355515155 
404,肯尼亚,42,湖北省,926562221 ,4164654 ,930726875 
404,肯尼亚,43,湖南省,1547148298 ,6301827 ,1553450125 
404,肯尼亚,44,广东省,7702444824 ,256500808 ,7958945632 
404,肯尼亚,45,广西壮族自治区,257848043 ,2022162 ,259870205 
404,肯尼亚,46,海南省,51073209 ,555664 ,51628873 
404,肯尼亚,50,重庆市,633576363 ,0 ,633576363 
404,肯尼亚,51,四川省,1041276682 ,114343569 ,1155620251 
404,肯尼亚,52,贵州省,89283988 ,414418 ,89698406 
404,肯尼亚,53,云南省,296128098 ,45321140 ,341449238 
404,肯尼亚,54,西藏自治区,959131 ,0 ,959131 
404,肯尼亚,61,陕西省,57935250 ,8749530 ,66684780 
404,肯尼亚,62,甘肃省,3383504 ,0 ,3383504 
404,肯尼亚,63,青海省,4757769 ,0 ,4757769 
404,肯尼亚,64,宁夏回族自治区,6216234 ,0 ,6216234 
404,肯尼亚,65,新疆维吾尔自治区,111115932 ,446968 ,111562900 
408,朝鲜,11,北京市,296041 ,201381 ,497422 
408,朝鲜,12,天津市,132083 ,163 ,132246 
408,朝鲜,13,河北省,271760117 ,5814253 ,277574370 
408,朝鲜,21,辽宁省,2198123974 ,434095790 ,2632219764 
408,朝鲜,22,吉林省,48033526 ,75265240 ,123298766 
408,朝鲜,23,黑龙江省,3273120 ,0 ,3273120 
408,朝鲜,31,上海市,2039217 ,2004 ,2041221 
408,朝鲜,32,江苏省,8349111 ,672 ,8349783 
408,朝鲜,33,浙江省,34660587 ,6559472 ,41220059 
408,朝鲜,34,安徽省,27681844 ,0 ,27681844 
408,朝鲜,35,福建省,14474910 ,0 ,14474910 
408,朝鲜,36,江西省,52324264 ,0 ,52324264 
408,朝鲜,37,山东省,468203413 ,14111314 ,482314727 
408,朝鲜,41,河南省,46773253 ,0 ,46773253 
408,朝鲜,42,湖北省,12975497 ,0 ,12975497 
408,朝鲜,43,湖南省,9590810 ,0 ,9590810 
408,朝鲜,44,广东省,233119615 ,3028298 ,236147913 
408,朝鲜,50,重庆市,4990557 ,0 ,4990557 
408,朝鲜,51,四川省,0 ,2420410 ,2420410 
408,朝鲜,64,宁夏回族自治区,22263 ,0 ,22263 
410,韩国,11,北京市,13483864589 ,16069019998 ,29552884587 
410,韩国,12,天津市,18846862801 ,37422307353 ,56269170154 
410,韩国,13,河北省,13323566286 ,2986110727 ,16309677013 
410,韩国,14,山西省,3806489571 ,3594180487 ,7400670058 
410,韩国,15,内蒙古自治区,2853533362 ,281505542 ,3135038904 
410,韩国,21,辽宁省,24853586316 ,19122546518 ,43976132834 
410,韩国,22,吉林省,2354297043 ,1965706166 ,4320003209 
410,韩国,23,黑龙江省,2018929984 ,126900082 ,2145830066 
410,韩国,31,上海市,50084082217 ,112804586213 ,162888668430 
410,韩国,32,江苏省,181046447460 ,261398080452 ,442444527912 
410,韩国,33,浙江省,67196236115 ,53000826805 ,120197062920 
410,韩国,34,安徽省,10886323126 ,16318401409 ,27204724535 
410,韩国,35,福建省,30869573485 ,14991582779 ,45861156264 
410,韩国,36,江西省,22724547324 ,9789024573 ,32513571897 
410,韩国,37,山东省,136108151406 ,69963056629 ,206071208035 
410,韩国,41,河南省,11038784351 ,44104134042 ,55142918393 
410,韩国,42,湖北省,13995954235 ,13421821489 ,27417775724 
410,韩国,43,湖南省,14167961285 ,6641599796 ,20809561081 
410,韩国,44,广东省,89875483173 ,218622024246 ,308497507419 
410,韩国,45,广西壮族自治区,2333067859 ,5964109553 ,8297177412 
410,韩国,46,海南省,1380490914 ,1707281220 ,3087772134 
410,韩国,50,重庆市,19512717484 ,40704085247 ,60216802731 
410,韩国,51,四川省,17136114780 ,29310983510 ,46447098290 
410,韩国,52,贵州省,2114291136 ,224204607 ,2338495743 
410,韩国,53,云南省,4432326272 ,177700985 ,4610027257 
410,韩国,54,西藏自治区,36634812 ,8998872 ,45633684 
410,韩国,61,陕西省,44364763263 ,27047644791 ,71412408054 
410,韩国,62,甘肃省,464171156 ,1392445773 ,1856616929 
410,韩国,63,青海省,110497198 ,599202 ,111096400 
410,韩国,64,宁夏回族自治区,961805032 ,245874669 ,1207679701 
410,韩国,65,新疆维吾尔自治区,447789199 ,85961167 ,533750366 
414,科威特,11,北京市,329671077 ,83966058126 ,84295729203 
414,科威特,12,天津市,449134307 ,26285425 ,475419732 
414,科威特,13,河北省,1064084345 ,33052119 ,1097136464 
414,科威特,14,山西省,47478083 ,1156 ,47479239 
414,科威特,15,内蒙古自治区,20400058 ,759217 ,21159275 
414,科威特,21,辽宁省,104291636 ,2100751994 ,2205043630 
414,科威特,22,吉林省,61595591 ,0 ,61595591 
414,科威特,23,黑龙江省,15568552 ,71226845 ,86795397 
414,科威特,31,上海市,1091638428 ,823371869 ,1915010297 
414,科威特,32,江苏省,1903952749 ,404299799 ,2308252548 
414,科威特,33,浙江省,3856729611 ,14009033591 ,17865763202 
414,科威特,34,安徽省,765566493 ,15865057 ,781431550 
414,科威特,35,福建省,1385247799 ,318805568 ,1704053367 
414,科威特,36,江西省,542359823 ,127223091 ,669582914 
414,科威特,37,山东省,2265373838 ,8591800851 ,10857174689 
414,科威特,41,河南省,930096319 ,4465 ,930100784 
414,科威特,42,湖北省,436329063 ,128874873 ,565203936 
414,科威特,43,湖南省,1433986543 ,829 ,1433987372 
414,科威特,44,广东省,4773681508 ,3356148353 ,8129829861 
414,科威特,45,广西壮族自治区,418969170 ,5396495548 ,5815464718 
414,科威特,46,海南省,17525456 ,130808446 ,148333902 
414,科威特,50,重庆市,524699554 ,0 ,524699554 
414,科威特,51,四川省,378414932 ,4405011 ,382819943 
414,科威特,52,贵州省,30240635 ,65196855 ,95437490 
414,科威特,53,云南省,173461569 ,10868627923 ,11042089492 
414,科威特,61,陕西省,291290124 ,970 ,291291094 
414,科威特,62,甘肃省,6882664 ,0 ,6882664 
414,科威特,63,青海省,634986 ,0 ,634986 
414,科威特,64,宁夏回族自治区,147583 ,0 ,147583 
414,科威特,65,新疆维吾尔自治区,30370263 ,0 ,30370263 
417,吉尔吉斯斯坦,11,北京市,345806026 ,1193053 ,346999079 
417,吉尔吉斯斯坦,12,天津市,1020828119 ,718436 ,1021546555 
417,吉尔吉斯斯坦,13,河北省,1131907096 ,8684388 ,1140591484 
417,吉尔吉斯斯坦,14,山西省,22183780 ,0 ,22183780 
417,吉尔吉斯斯坦,15,内蒙古自治区,51070580 ,0 ,51070580 
417,吉尔吉斯斯坦,21,辽宁省,41672732 ,310 ,41673042 
417,吉尔吉斯斯坦,22,吉林省,1449933 ,0 ,1449933 
417,吉尔吉斯斯坦,23,黑龙江省,8086411 ,0 ,8086411 
417,吉尔吉斯斯坦,31,上海市,337783393 ,1938385 ,339721778 
417,吉尔吉斯斯坦,32,江苏省,631723905 ,31396 ,631755301 
417,吉尔吉斯斯坦,33,浙江省,1858757403 ,1983643 ,1860741046 
417,吉尔吉斯斯坦,34,安徽省,140158795 ,56922602 ,197081397 
417,吉尔吉斯斯坦,35,福建省,388768236 ,4389 ,388772625 
417,吉尔吉斯斯坦,36,江西省,437814032 ,5294931 ,443108963 
417,吉尔吉斯斯坦,37,山东省,1407911778 ,9943169 ,1417854947 
417,吉尔吉斯斯坦,41,河南省,187626431 ,4214 ,187630645 
417,吉尔吉斯斯坦,42,湖北省,587864893 ,2331941 ,590196834 
417,吉尔吉斯斯坦,43,湖南省,2249947258 ,2070740 ,2252017998 
417,吉尔吉斯斯坦,44,广东省,698049380 ,180369775 ,878419155 
417,吉尔吉斯斯坦,45,广西壮族自治区,67095299 ,0 ,67095299 
417,吉尔吉斯斯坦,46,海南省,78562570 ,0 ,78562570 
417,吉尔吉斯斯坦,50,重庆市,23715063 ,0 ,23715063 
417,吉尔吉斯斯坦,51,四川省,220525896 ,137233819 ,357759715 
417,吉尔吉斯斯坦,52,贵州省,74516668 ,0 ,74516668 
417,吉尔吉斯斯坦,53,云南省,23735218 ,0 ,23735218 
417,吉尔吉斯斯坦,54,西藏自治区,0 ,7581749 ,7581749 
417,吉尔吉斯斯坦,61,陕西省,92472032 ,9561 ,92481593 
417,吉尔吉斯斯坦,62,甘肃省,8048368 ,0 ,8048368 
417,吉尔吉斯斯坦,63,青海省,465574 ,0 ,465574 
417,吉尔吉斯斯坦,64,宁夏回族自治区,57841030 ,0 ,57841030 
417,吉尔吉斯斯坦,65,新疆维吾尔自治区,60775307681 ,53364228 ,60828671909 
418,老挝,11,北京市,946288660 ,2041471715 ,2987760375 
418,老挝,12,天津市,65068590 ,72467769 ,137536359 
418,老挝,13,河北省,392232112 ,7236151 ,399468263 
418,老挝,14,山西省,17750977 ,164436503 ,182187480 
418,老挝,15,内蒙古自治区,2386145 ,323428 ,2709573 
418,老挝,21,辽宁省,115678050 ,105911552 ,221589602 
418,老挝,22,吉林省,35558848 ,13712242 ,49271090 
418,老挝,23,黑龙江省,99796263 ,2016583 ,101812846 
418,老挝,31,上海市,185984200 ,1895785865 ,2081770065 
418,老挝,32,江苏省,775951986 ,108154723 ,884106709 
418,老挝,33,浙江省,770614898 ,266291798 ,1036906696 
418,老挝,34,安徽省,486810789 ,313463912 ,800274701 
418,老挝,35,福建省,95377376 ,506313283 ,601690659 
418,老挝,36,江西省,639106968 ,170613870 ,809720838 
418,老挝,37,山东省,1149823296 ,2991453619 ,4141276915 
418,老挝,41,河南省,73578761 ,7452584 ,81031345 
418,老挝,42,湖北省,323406055 ,14363541 ,337769596 
418,老挝,43,湖南省,837629761 ,80787400 ,918417161 
418,老挝,44,广东省,958264299 ,131053493 ,1089317792 
418,老挝,45,广西壮族自治区,165355585 ,252575092 ,417930677 
418,老挝,46,海南省,485441309 ,12863081 ,498304390 
418,老挝,50,重庆市,208245771 ,1738550 ,209984321 
418,老挝,51,四川省,350923279 ,56891159 ,407814438 
418,老挝,52,贵州省,34163454 ,429226 ,34592680 
418,老挝,53,云南省,1837400341 ,6331437464 ,8168837805 
418,老挝,54,西藏自治区,0 ,3660359 ,3660359 
418,老挝,61,陕西省,192168929 ,146867611 ,339036540 
418,老挝,62,甘肃省,1662006 ,50655 ,1712661 
418,老挝,64,宁夏回族自治区,247497 ,0 ,247497 
418,老挝,65,新疆维吾尔自治区,7705804 ,6884297 ,14590101 
422,黎巴嫩,11,北京市,133970844 ,4137565 ,138108409 
422,黎巴嫩,12,天津市,125600699 ,2857591 ,128458290 
422,黎巴嫩,13,河北省,141473765 ,2015 ,141475780 
422,黎巴嫩,14,山西省,6347176 ,0 ,6347176 
422,黎巴嫩,15,内蒙古自治区,21797522 ,0 ,21797522 
422,黎巴嫩,21,辽宁省,45113337 ,5130 ,45118467 
422,黎巴嫩,22,吉林省,2441231 ,0 ,2441231 
422,黎巴嫩,23,黑龙江省,14698597 ,5161 ,14703758 
422,黎巴嫩,31,上海市,245427717 ,23085973 ,268513690 
422,黎巴嫩,32,江苏省,1463324512 ,470757 ,1463795269 
422,黎巴嫩,33,浙江省,3160280545 ,259819994 ,3420100539 
422,黎巴嫩,34,安徽省,722787659 ,16616 ,722804275 
422,黎巴嫩,35,福建省,351163556 ,1801547 ,352965103 
422,黎巴嫩,36,江西省,494795931 ,1178122 ,495974053 
422,黎巴嫩,37,山东省,1019713521 ,51871 ,1019765392 
422,黎巴嫩,41,河南省,161451907 ,1591508 ,163043415 
422,黎巴嫩,42,湖北省,212984105 ,442652 ,213426757 
422,黎巴嫩,43,湖南省,283939261 ,4107 ,283943368 
422,黎巴嫩,44,广东省,2907831204 ,15738199 ,2923569403 
422,黎巴嫩,45,广西壮族自治区,110671634 ,35814590 ,146486224 
422,黎巴嫩,46,海南省,18452467 ,10118 ,18462585 
422,黎巴嫩,50,重庆市,161783928 ,0 ,161783928 
422,黎巴嫩,51,四川省,299296492 ,62203 ,299358695 
422,黎巴嫩,52,贵州省,17454445 ,0 ,17454445 
422,黎巴嫩,53,云南省,122463417 ,0 ,122463417 
422,黎巴嫩,54,西藏自治区,461813 ,0 ,461813 
422,黎巴嫩,61,陕西省,151672680 ,1958 ,151674638 
422,黎巴嫩,62,甘肃省,10025777 ,0 ,10025777 
422,黎巴嫩,63,青海省,866002 ,0 ,866002 
422,黎巴嫩,64,宁夏回族自治区,11616973 ,0 ,11616973 
422,黎巴嫩,65,新疆维吾尔自治区,17059694 ,0 ,17059694 
426,莱索托,11,北京市,5750344 ,16873919 ,22624263 
426,莱索托,12,天津市,1105232 ,0 ,1105232 
426,莱索托,13,河北省,2757448 ,0 ,2757448 
426,莱索托,21,辽宁省,1780597 ,65 ,1780662 
426,莱索托,23,黑龙江省,752715 ,0 ,752715 
426,莱索托,31,上海市,53582725 ,27047668 ,80630393 
426,莱索托,32,江苏省,109522862 ,60103188 ,169626050 
426,莱索托,33,浙江省,84112096 ,10409371 ,94521467 
426,莱索托,34,安徽省,3085564 ,0 ,3085564 
426,莱索托,35,福建省,16396603 ,3345 ,16399948 
426,莱索托,36,江西省,1702861 ,0 ,1702861 
426,莱索托,37,山东省,19982024 ,3454447 ,23436471 
426,莱索托,41,河南省,580710 ,0 ,580710 
426,莱索托,42,湖北省,5773789 ,648 ,5774437 
426,莱索托,43,湖南省,2397235 ,857 ,2398092 
426,莱索托,44,广东省,31785555 ,1747945 ,33533500 
426,莱索托,45,广西壮族自治区,596804 ,0 ,596804 
426,莱索托,50,重庆市,186053 ,0 ,186053 
426,莱索托,51,四川省,35091 ,176 ,35267 
426,莱索托,61,陕西省,627861 ,0 ,627861 
428,拉脱维亚,11,北京市,91149265 ,89304228 ,180453493 
428,拉脱维亚,12,天津市,38447344 ,7838445 ,46285789 
428,拉脱维亚,13,河北省,91010354 ,61854346 ,152864700 
428,拉脱维亚,14,山西省,1387176 ,5433254 ,6820430 
428,拉脱维亚,15,内蒙古自治区,4239742 ,0 ,4239742 
428,拉脱维亚,21,辽宁省,63709533 ,42743677 ,106453210 
428,拉脱维亚,22,吉林省,7088460 ,357773 ,7446233 
428,拉脱维亚,23,黑龙江省,9284570 ,47149081 ,56433651 
428,拉脱维亚,31,上海市,322221184 ,296755060 ,618976244 
428,拉脱维亚,32,江苏省,896526370 ,302867470 ,1199393840 
428,拉脱维亚,33,浙江省,1147464264 ,312194274 ,1459658538 
428,拉脱维亚,34,安徽省,132068033 ,47146622 ,179214655 
428,拉脱维亚,35,福建省,124148555 ,361937844 ,486086399 
428,拉脱维亚,36,江西省,34550835 ,6822683 ,41373518 
428,拉脱维亚,37,山东省,565024136 ,117013767 ,682037903 
428,拉脱维亚,41,河南省,41732285 ,528567 ,42260852 
428,拉脱维亚,42,湖北省,246431431 ,38390558 ,284821989 
428,拉脱维亚,43,湖南省,60487245 ,208898 ,60696143 
428,拉脱维亚,44,广东省,1056206929 ,93776802 ,1149983731 
428,拉脱维亚,45,广西壮族自治区,13797058 ,3259062 ,17056120 
428,拉脱维亚,46,海南省,5459748 ,2182245 ,7641993 
428,拉脱维亚,50,重庆市,86295229 ,257946 ,86553175 
428,拉脱维亚,51,四川省,58800548 ,5222157 ,64022705 
428,拉脱维亚,52,贵州省,111613423 ,16354 ,111629777 
428,拉脱维亚,53,云南省,5432265 ,455612 ,5887877 
428,拉脱维亚,54,西藏自治区,0 ,7959 ,7959 
428,拉脱维亚,61,陕西省,8391555 ,1465924 ,9857479 
428,拉脱维亚,62,甘肃省,129047 ,0 ,129047 
428,拉脱维亚,63,青海省,196463 ,0 ,196463 
428,拉脱维亚,64,宁夏回族自治区,36795 ,0 ,36795 
428,拉脱维亚,65,新疆维吾尔自治区,13381290 ,0 ,13381290 
430,利比里亚,11,北京市,3304123905 ,708477 ,3304832382 
430,利比里亚,12,天津市,879489647 ,0 ,879489647 
430,利比里亚,13,河北省,151543656 ,0 ,151543656 
430,利比里亚,14,山西省,785890 ,0 ,785890 
430,利比里亚,15,内蒙古自治区,125657 ,0 ,125657 
430,利比里亚,21,辽宁省,2406960200 ,0 ,2406960200 
430,利比里亚,22,吉林省,2610822 ,0 ,2610822 
430,利比里亚,23,黑龙江省,16439934 ,0 ,16439934 
430,利比里亚,31,上海市,3185188998 ,1747164 ,3186936162 
430,利比里亚,32,江苏省,7183177230 ,18437726 ,7201614956 
430,利比里亚,33,浙江省,15596921868 ,702486 ,15597624354 
430,利比里亚,34,安徽省,63646068 ,0 ,63646068 
430,利比里亚,35,福建省,208746496 ,270 ,208746766 
430,利比里亚,36,江西省,113452297 ,254097 ,113706394 
430,利比里亚,37,山东省,2318756954 ,1792 ,2318758746 
430,利比里亚,41,河南省,63926706 ,3817 ,63930523 
430,利比里亚,42,湖北省,373285872 ,0 ,373285872 
430,利比里亚,43,湖南省,137573417 ,0 ,137573417 
430,利比里亚,44,广东省,1610303162 ,22815042 ,1633118204 
430,利比里亚,45,广西壮族自治区,12748682 ,31926404 ,44675086 
430,利比里亚,46,海南省,5544391 ,3003705 ,8548096 
430,利比里亚,50,重庆市,57416640 ,0 ,57416640 
430,利比里亚,51,四川省,74298940 ,0 ,74298940 
430,利比里亚,52,贵州省,9909357 ,0 ,9909357 
430,利比里亚,53,云南省,52347094 ,0 ,52347094 
430,利比里亚,61,陕西省,2558713 ,0 ,2558713 
430,利比里亚,62,甘肃省,673429 ,0 ,673429 
430,利比里亚,65,新疆维吾尔自治区,3723629 ,0 ,3723629 
434,利比亚,11,北京市,10640484 ,14389044803 ,14399685287 
434,利比亚,12,天津市,60641154 ,0 ,60641154 
434,利比亚,13,河北省,215441846 ,1005 ,215442851 
434,利比亚,14,山西省,1084760 ,0 ,1084760 
434,利比亚,15,内蒙古自治区,14010371 ,0 ,14010371 
434,利比亚,21,辽宁省,39186370 ,0 ,39186370 
434,利比亚,22,吉林省,9063293 ,0 ,9063293 
434,利比亚,23,黑龙江省,7226381 ,0 ,7226381 
434,利比亚,31,上海市,184474945 ,91248 ,184566193 
434,利比亚,32,江苏省,530346848 ,112 ,530346960 
434,利比亚,33,浙江省,4321219660 ,4217 ,4321223877 
434,利比亚,34,安徽省,176948747 ,0 ,176948747 
434,利比亚,35,福建省,912644251 ,956 ,912645207 
434,利比亚,36,江西省,277253456 ,0 ,277253456 
434,利比亚,37,山东省,1128086099 ,45707 ,1128131806 
434,利比亚,41,河南省,66533149 ,0 ,66533149 
434,利比亚,42,湖北省,213436877 ,580 ,213437457 
434,利比亚,43,湖南省,385449815 ,56394 ,385506209 
434,利比亚,44,广东省,2126889991 ,63320 ,2126953311 
434,利比亚,45,广西壮族自治区,51453022 ,0 ,51453022 
434,利比亚,50,重庆市,176441648 ,0 ,176441648 
434,利比亚,51,四川省,118099262 ,67 ,118099329 
434,利比亚,52,贵州省,20133606 ,0 ,20133606 
434,利比亚,53,云南省,63273323 ,0 ,63273323 
434,利比亚,61,陕西省,16185555 ,0 ,16185555 
434,利比亚,62,甘肃省,5606592 ,0 ,5606592 
434,利比亚,63,青海省,2355653 ,0 ,2355653 
434,利比亚,65,新疆维吾尔自治区,6166586 ,0 ,6166586 
438,列支敦士登,11,北京市,5229922 ,86043544 ,91273466 
438,列支敦士登,12,天津市,315102 ,8421750 ,8736852 
438,列支敦士登,13,河北省,39 ,1789016 ,1789055 
438,列支敦士登,21,辽宁省,5150263 ,28468892 ,33619155 
438,列支敦士登,22,吉林省,438759 ,440708 ,879467 
438,列支敦士登,23,黑龙江省,7600 ,0 ,7600 
438,列支敦士登,31,上海市,80879892 ,425347601 ,506227493 
438,列支敦士登,32,江苏省,113267266 ,108912959 ,222180225 
438,列支敦士登,33,浙江省,80534646 ,9418410 ,89953056 
438,列支敦士登,34,安徽省,4937142 ,9202743 ,14139885 
438,列支敦士登,35,福建省,910309 ,25548736 ,26459045 
438,列支敦士登,36,江西省,2054651 ,449505 ,2504156 
438,列支敦士登,37,山东省,733294 ,19948555 ,20681849 
438,列支敦士登,41,河南省,0 ,12714124 ,12714124 
438,列支敦士登,42,湖北省,253193 ,2459255 ,2712448 
438,列支敦士登,43,湖南省,3725321 ,1127712 ,4853033 
438,列支敦士登,44,广东省,33023790 ,182723832 ,215747622 
438,列支敦士登,50,重庆市,0 ,3393157 ,3393157 
438,列支敦士登,51,四川省,1731560 ,358567 ,2090127 
438,列支敦士登,53,云南省,39 ,0 ,39 
438,列支敦士登,61,陕西省,369167 ,1700647 ,2069814 
438,列支敦士登,62,甘肃省,11270 ,0 ,11270 
440,立陶宛,11,北京市,464838708 ,53115864 ,517954572 
440,立陶宛,12,天津市,328490975 ,40550681 ,369041656 
440,立陶宛,13,河北省,113184963 ,4286 ,113189249 
440,立陶宛,14,山西省,11744717 ,2172 ,11746889 
440,立陶宛,15,内蒙古自治区,36500066 ,2365904 ,38865970 
440,立陶宛,21,辽宁省,77400447 ,6703135 ,84103582 
440,立陶宛,22,吉林省,47991016 ,29777725 ,77768741 
440,立陶宛,23,黑龙江省,34082695 ,1868844 ,35951539 
440,立陶宛,31,上海市,527870959 ,134385117 ,662256076 
440,立陶宛,32,江苏省,1186286965 ,21067244 ,1207354209 
440,立陶宛,33,浙江省,1862108650 ,81906762 ,1944015412 
440,立陶宛,34,安徽省,293258637 ,4298570 ,297557207 
440,立陶宛,35,福建省,329900162 ,967403 ,330867565 
440,立陶宛,36,江西省,99415272 ,13199 ,99428471 
440,立陶宛,37,山东省,622865150 ,4997731 ,627862881 
440,立陶宛,41,河南省,68922013 ,18249 ,68940262 
440,立陶宛,42,湖北省,72623575 ,7341788 ,79965363 
440,立陶宛,43,湖南省,78574189 ,319097 ,78893286 
440,立陶宛,44,广东省,2012539505 ,29802903 ,2042342408 
440,立陶宛,45,广西壮族自治区,9950776 ,0 ,9950776 
440,立陶宛,46,海南省,104279930 ,35372 ,104315302 
440,立陶宛,50,重庆市,139703240 ,13458 ,139716698 
440,立陶宛,51,四川省,215005931 ,3044240 ,218050171 
440,立陶宛,52,贵州省,20317623 ,0 ,20317623 
440,立陶宛,53,云南省,16684790 ,7067 ,16691857 
440,立陶宛,54,西藏自治区,7 ,0 ,7 
440,立陶宛,61,陕西省,44659914 ,2489711 ,47149625 
440,立陶宛,62,甘肃省,2636335 ,0 ,2636335 
440,立陶宛,63,青海省,117 ,0 ,117 
440,立陶宛,64,宁夏回族自治区,44740 ,0 ,44740 
440,立陶宛,65,新疆维吾尔自治区,122460176 ,1056 ,122461232 
442,卢森堡,11,北京市,53743177 ,29457285 ,83200462 
442,卢森堡,12,天津市,39929273 ,14140829 ,54070102 
442,卢森堡,13,河北省,14645019 ,61647255 ,76292274 
442,卢森堡,14,山西省,3324367 ,0 ,3324367 
442,卢森堡,15,内蒙古自治区,973972 ,4489344 ,5463316 
442,卢森堡,21,辽宁省,12268512 ,86131660 ,98400172 
442,卢森堡,22,吉林省,45918 ,5987358 ,6033276 
442,卢森堡,23,黑龙江省,1291 ,228130 ,229421 
442,卢森堡,31,上海市,289165364 ,534167487 ,823332851 
442,卢森堡,32,江苏省,306544111 ,312206774 ,618750885 
442,卢森堡,33,浙江省,195531640 ,76600025 ,272131665 
442,卢森堡,34,安徽省,105268364 ,11295193 ,116563557 
442,卢森堡,35,福建省,17024216 ,34733711 ,51757927 
442,卢森堡,36,江西省,4471127 ,190439 ,4661566 
442,卢森堡,37,山东省,47076145 ,17693676 ,64769821 
442,卢森堡,41,河南省,14714684 ,130334 ,14845018 
442,卢森堡,42,湖北省,3372150 ,1845311 ,5217461 
442,卢森堡,43,湖南省,2798161 ,2916359 ,5714520 
442,卢森堡,44,广东省,1266433319 ,379135660 ,1645568979 
442,卢森堡,45,广西壮族自治区,1668271 ,9135 ,1677406 
442,卢森堡,46,海南省,39 ,0 ,39 
442,卢森堡,50,重庆市,2225591 ,22120080 ,24345671 
442,卢森堡,51,四川省,179840080 ,2915613 ,182755693 
442,卢森堡,52,贵州省,2738 ,0 ,2738 
442,卢森堡,53,云南省,4108 ,3098 ,7206 
442,卢森堡,61,陕西省,3471475 ,82245411 ,85716886 
442,卢森堡,63,青海省,39 ,0 ,39 
442,卢森堡,64,宁夏回族自治区,1230679 ,0 ,1230679 
442,卢森堡,65,新疆维吾尔自治区,6737985 ,0 ,6737985 
446,中国澳门,11,北京市,1091754481 ,6758203 ,1098512684 
446,中国澳门,12,天津市,351986126 ,8707246 ,360693372 
446,中国澳门,13,河北省,153621383 ,0 ,153621383 
446,中国澳门,14,山西省,9132105 ,0 ,9132105 
446,中国澳门,15,内蒙古自治区,13749215 ,0 ,13749215 
446,中国澳门,21,辽宁省,110181988 ,8882059 ,119064047 
446,中国澳门,22,吉林省,2158133 ,0 ,2158133 
446,中国澳门,23,黑龙江省,5607394 ,0 ,5607394 
446,中国澳门,31,上海市,667662347 ,14018809 ,681681156 
446,中国澳门,32,江苏省,707189089 ,6750292 ,713939381 
446,中国澳门,33,浙江省,826642862 ,7243164 ,833886026 
446,中国澳门,34,安徽省,32706254 ,871 ,32707125 
446,中国澳门,35,福建省,352937328 ,490374 ,353427702 
446,中国澳门,36,江西省,416161395 ,0 ,416161395 
446,中国澳门,37,山东省,405136522 ,3670 ,405140192 
446,中国澳门,41,河南省,62336037 ,381513 ,62717550 
446,中国澳门,42,湖北省,410048986 ,106684 ,410155670 
446,中国澳门,43,湖南省,230875961 ,14176 ,230890137 
446,中国澳门,44,广东省,11942622126 ,313455293 ,12256077419 
446,中国澳门,45,广西壮族自治区,1999689031 ,61686 ,1999750717 
446,中国澳门,46,海南省,704887250 ,1113519 ,706000769 
446,中国澳门,50,重庆市,60170000 ,1487019 ,61657019 
446,中国澳门,51,四川省,116455601 ,1821158 ,118276759 
446,中国澳门,52,贵州省,78810253 ,0 ,78810253 
446,中国澳门,53,云南省,5831558 ,0 ,5831558 
446,中国澳门,54,西藏自治区,370959 ,0 ,370959 
446,中国澳门,61,陕西省,38822788 ,1164 ,38823952 
446,中国澳门,62,甘肃省,330145 ,0 ,330145 
446,中国澳门,63,青海省,5533431 ,0 ,5533431 
446,中国澳门,64,宁夏回族自治区,1738703 ,0 ,1738703 
446,中国澳门,65,新疆维吾尔自治区,142723 ,0 ,142723 
450,马达加斯加,11,北京市,89607610 ,15520674 ,105128284 
450,马达加斯加,12,天津市,77776719 ,25251026 ,103027745 
450,马达加斯加,13,河北省,353375350 ,179111 ,353554461 
450,马达加斯加,14,山西省,2888733 ,171740743 ,174629476 
450,马达加斯加,15,内蒙古自治区,150496888 ,3375238 ,153872126 
450,马达加斯加,21,辽宁省,19328221 ,37563411 ,56891632 
450,马达加斯加,22,吉林省,958929 ,0 ,958929 
450,马达加斯加,23,黑龙江省,3838632 ,5582710 ,9421342 
450,马达加斯加,31,上海市,269529570 ,629470817 ,899000387 
450,马达加斯加,32,江苏省,747960232 ,68241714 ,816201946 
450,马达加斯加,33,浙江省,1650707411 ,233404380 ,1884111791 
450,马达加斯加,34,安徽省,93488270 ,1093233 ,94581503 
450,马达加斯加,35,福建省,483798362 ,60713199 ,544511561 
450,马达加斯加,36,江西省,355448344 ,12808075 ,368256419 
450,马达加斯加,37,山东省,903563079 ,135982876 ,1039545955 
450,马达加斯加,41,河南省,16781803 ,9185664 ,25967467 
450,马达加斯加,42,湖北省,177810952 ,61516075 ,239327027 
450,马达加斯加,43,湖南省,317430992 ,333741435 ,651172427 
450,马达加斯加,44,广东省,1008816403 ,1075120911 ,2083937314 
450,马达加斯加,45,广西壮族自治区,35473798 ,3352953 ,38826751 
450,马达加斯加,46,海南省,1678436 ,66037207 ,67715643 
450,马达加斯加,50,重庆市,164498947 ,201575 ,164700522 
450,马达加斯加,51,四川省,189360126 ,677953 ,190038079 
450,马达加斯加,52,贵州省,8053738 ,0 ,8053738 
450,马达加斯加,53,云南省,69873777 ,0 ,69873777 
450,马达加斯加,54,西藏自治区,445271 ,0 ,445271 
450,马达加斯加,61,陕西省,43708620 ,20322 ,43728942 
450,马达加斯加,62,甘肃省,548244 ,166367248 ,166915492 
450,马达加斯加,64,宁夏回族自治区,3306125 ,0 ,3306125 
450,马达加斯加,65,新疆维吾尔自治区,5551499 ,131851 ,5683350 
454,马拉维,11,北京市,356991845 ,27370791 ,384362636 
454,马拉维,12,天津市,88265656 ,0 ,88265656 
454,马拉维,13,河北省,20909924 ,0 ,20909924 
454,马拉维,14,山西省,3756016 ,0 ,3756016 
454,马拉维,15,内蒙古自治区,1196738 ,0 ,1196738 
454,马拉维,21,辽宁省,2334499 ,21754 ,2356253 
454,马拉维,22,吉林省,3325 ,0 ,3325 
454,马拉维,23,黑龙江省,39773 ,0 ,39773 
454,马拉维,31,上海市,52239971 ,163182 ,52403153 
454,马拉维,32,江苏省,84181873 ,174450 ,84356323 
454,马拉维,33,浙江省,153991224 ,15168692 ,169159916 
454,马拉维,34,安徽省,20421568 ,11800000 ,32221568 
454,马拉维,35,福建省,48684376 ,3538903 ,52223279 
454,马拉维,36,江西省,50045186 ,1379930 ,51425116 
454,马拉维,37,山东省,193613638 ,421186 ,194034824 
454,马拉维,41,河南省,12495066 ,0 ,12495066 
454,马拉维,42,湖北省,7317799 ,0 ,7317799 
454,马拉维,43,湖南省,25732958 ,0 ,25732958 
454,马拉维,44,广东省,251799795 ,41556 ,251841351 
454,马拉维,45,广西壮族自治区,4544975 ,0 ,4544975 
454,马拉维,46,海南省,10342 ,0 ,10342 
454,马拉维,50,重庆市,50713147 ,0 ,50713147 
454,马拉维,51,四川省,38726572 ,2352 ,38728924 
454,马拉维,52,贵州省,2886165 ,3975 ,2890140 
454,马拉维,53,云南省,6982426 ,0 ,6982426 
454,马拉维,61,陕西省,2349303 ,0 ,2349303 
454,马拉维,62,甘肃省,8778 ,0 ,8778 
454,马拉维,65,新疆维吾尔自治区,113453 ,0 ,113453 
458,马来西亚,11,北京市,10506290187 ,26297999981 ,36804290168 
458,马来西亚,12,天津市,8048313517 ,10927003761 ,18975317278 
458,马来西亚,13,河北省,6415439380 ,5852800382 ,12268239762 
458,马来西亚,14,山西省,436097461 ,377536945 ,813634406 
458,马来西亚,15,内蒙古自治区,618227694 ,467475171 ,1085702865 
458,马来西亚,21,辽宁省,3222458829 ,6189164108 ,9411622937 
458,马来西亚,22,吉林省,304332699 ,937071562 ,1241404261 
458,马来西亚,23,黑龙江省,455712097 ,90928334 ,546640431 
458,马来西亚,31,上海市,24724407918 ,61667976589 ,86392384507 
458,马来西亚,32,江苏省,50364830184 ,48487937792 ,98852767976 
458,马来西亚,33,浙江省,37647188168 ,24709357767 ,62356545935 
458,马来西亚,34,安徽省,5922430723 ,7362026615 ,13284457338 
458,马来西亚,35,福建省,28420641211 ,14017685414 ,42438326625 
458,马来西亚,36,江西省,14131852114 ,2932384223 ,17064236337 
458,马来西亚,37,山东省,45499934706 ,145701314834 ,191201249540 
458,马来西亚,41,河南省,5946076380 ,5051264902 ,10997341282 
458,马来西亚,42,湖北省,10591919841 ,4129241183 ,14721161024 
458,马来西亚,43,湖南省,17196847991 ,8819423285 ,26016271276 
458,马来西亚,44,广东省,96867697725 ,124237638354 ,221105336079 
458,马来西亚,45,广西壮族自治区,6582481895 ,4283441479 ,10865923374 
458,马来西亚,46,海南省,1755157167 ,2516169103 ,4271326270 
458,马来西亚,50,重庆市,5825791289 ,12290330608 ,18116121897 
458,马来西亚,51,四川省,37837379999 ,6313652730 ,44151032729 
458,马来西亚,52,贵州省,1182588596 ,1097822098 ,2280410694 
458,马来西亚,53,云南省,10669476840 ,2016892976 ,12686369816 
458,马来西亚,54,西藏自治区,27206788 ,271047 ,27477835 
458,马来西亚,61,陕西省,15602149442 ,5103975359 ,20706124801 
458,马来西亚,62,甘肃省,119664699 ,281593929 ,401258628 
458,马来西亚,63,青海省,150847450 ,0 ,150847450 
458,马来西亚,64,宁夏回族自治区,654338625 ,19091338 ,673429963 
458,马来西亚,65,新疆维吾尔自治区,441093960 ,22942567 ,464036527 
462,马尔代夫,11,北京市,156427183 ,12225 ,156439408 
462,马尔代夫,12,天津市,73060522 ,0 ,73060522 
462,马尔代夫,13,河北省,32477958 ,3987 ,32481945 
462,马尔代夫,14,山西省,1129804 ,0 ,1129804 
462,马尔代夫,15,内蒙古自治区,991164 ,0 ,991164 
462,马尔代夫,21,辽宁省,6424627 ,0 ,6424627 
462,马尔代夫,22,吉林省,744192 ,0 ,744192 
462,马尔代夫,23,黑龙江省,1040966 ,0 ,1040966 
462,马尔代夫,31,上海市,43619790 ,13806 ,43633596 
462,马尔代夫,32,江苏省,171654942 ,37990 ,171692932 
462,马尔代夫,33,浙江省,239441278 ,902 ,239442180 
462,马尔代夫,34,安徽省,28749961 ,0 ,28749961 
462,马尔代夫,35,福建省,76380174 ,255 ,76380429 
462,马尔代夫,36,江西省,67521363 ,0 ,67521363 
462,马尔代夫,37,山东省,254806730 ,15942 ,254822672 
462,马尔代夫,41,河南省,60927386 ,0 ,60927386 
462,马尔代夫,42,湖北省,64070057 ,0 ,64070057 
462,马尔代夫,43,湖南省,121835979 ,0 ,121835979 
462,马尔代夫,44,广东省,605915114 ,242158 ,606157272 
462,马尔代夫,45,广西壮族自治区,9463155 ,0 ,9463155 
462,马尔代夫,46,海南省,1230692 ,0 ,1230692 
462,马尔代夫,50,重庆市,32749841 ,0 ,32749841 
462,马尔代夫,51,四川省,49889072 ,1477 ,49890549 
462,马尔代夫,52,贵州省,1825072 ,0 ,1825072 
462,马尔代夫,53,云南省,37646176 ,0 ,37646176 
462,马尔代夫,61,陕西省,921169 ,0 ,921169 
462,马尔代夫,62,甘肃省,202954 ,0 ,202954 
462,马尔代夫,65,新疆维吾尔自治区,2290475 ,0 ,2290475 
466,马里,11,北京市,140609974 ,189440054 ,330050028 
466,马里,12,天津市,30435343 ,31594356 ,62029699 
466,马里,13,河北省,173690088 ,561 ,173690649 
466,马里,14,山西省,21403 ,0 ,21403 
466,马里,15,内蒙古自治区,260841 ,0 ,260841 
466,马里,21,辽宁省,13482592 ,30939 ,13513531 
466,马里,22,吉林省,264485 ,0 ,264485 
466,马里,23,黑龙江省,189039 ,0 ,189039 
466,马里,31,上海市,99773307 ,44932157 ,144705464 
466,马里,32,江苏省,234280045 ,17978610 ,252258655 
466,马里,33,浙江省,328983659 ,13524638 ,342508297 
466,马里,34,安徽省,32405841 ,29960769 ,62366610 
466,马里,35,福建省,210679274 ,21567020 ,232246294 
466,马里,36,江西省,24452637 ,97422 ,24550059 
466,马里,37,山东省,388899266 ,92991269 ,481890535 
466,马里,41,河南省,28549351 ,0 ,28549351 
466,马里,42,湖北省,22740588 ,22887202 ,45627790 
466,马里,43,湖南省,18943820 ,42071 ,18985891 
466,马里,44,广东省,707318368 ,58565257 ,765883625 
466,马里,45,广西壮族自治区,27237872 ,4431297 ,31669169 
466,马里,46,海南省,5554138 ,0 ,5554138 
466,马里,50,重庆市,154235595 ,0 ,154235595 
466,马里,51,四川省,34373555 ,3001 ,34376556 
466,马里,52,贵州省,18030409 ,0 ,18030409 
466,马里,53,云南省,2898734 ,0 ,2898734 
466,马里,61,陕西省,12377484 ,1136 ,12378620 
466,马里,62,甘肃省,155513 ,0 ,155513 
466,马里,65,新疆维吾尔自治区,446484 ,0 ,446484 
470,马耳他,11,北京市,633565812 ,26515219 ,660081031 
470,马耳他,12,天津市,162610195 ,73079660 ,235689855 
470,马耳他,13,河北省,48751210 ,96091745 ,144842955 
470,马耳他,14,山西省,88500 ,0 ,88500 
470,马耳他,15,内蒙古自治区,1503664 ,0 ,1503664 
470,马耳他,21,辽宁省,356633162 ,12694587 ,369327749 
470,马耳他,22,吉林省,1768 ,56185487 ,56187255 
470,马耳他,23,黑龙江省,4862501 ,7000 ,4869501 
470,马耳他,31,上海市,1983481959 ,605752977 ,2589234936 
470,马耳他,32,江苏省,1644571723 ,604460945 ,2249032668 
470,马耳他,33,浙江省,2975319965 ,29869417 ,3005189382 
470,马耳他,34,安徽省,36653571 ,10211199 ,46864770 
470,马耳他,35,福建省,180709141 ,7364223 ,188073364 
470,马耳他,36,江西省,68665657 ,18528716 ,87194373 
470,马耳他,37,山东省,512588258 ,28266956 ,540855214 
470,马耳他,41,河南省,31954435 ,242745 ,32197180 
470,马耳他,42,湖北省,90945921 ,10871020 ,101816941 
470,马耳他,43,湖南省,270742994 ,32984457 ,303727451 
470,马耳他,44,广东省,1004792382 ,1134789907 ,2139582289 
470,马耳他,45,广西壮族自治区,13615107 ,1481479 ,15096586 
470,马耳他,46,海南省,23447 ,44608 ,68055 
470,马耳他,50,重庆市,15795971 ,33888657 ,49684628 
470,马耳他,51,四川省,49093657 ,17415453 ,66509110 
470,马耳他,52,贵州省,38911001 ,0 ,38911001 
470,马耳他,53,云南省,38321359 ,0 ,38321359 
470,马耳他,61,陕西省,12449321 ,1478536 ,13927857 
470,马耳他,62,甘肃省,1735190 ,2819 ,1738009 
470,马耳他,63,青海省,638251 ,0 ,638251 
470,马耳他,64,宁夏回族自治区,0 ,51390 ,51390 
470,马耳他,65,新疆维吾尔自治区,803138 ,0 ,803138 
474,马提尼克,11,北京市,279539 ,1368 ,280907 
474,马提尼克,12,天津市,886381 ,0 ,886381 
474,马提尼克,13,河北省,3510095 ,0 ,3510095 
474,马提尼克,14,山西省,10494 ,0 ,10494 
474,马提尼克,21,辽宁省,635341 ,0 ,635341 
474,马提尼克,23,黑龙江省,1323 ,0 ,1323 
474,马提尼克,31,上海市,12972205 ,8232 ,12980437 
474,马提尼克,32,江苏省,28001018 ,933 ,28001951 
474,马提尼克,33,浙江省,55437010 ,3923 ,55440933 
474,马提尼克,34,安徽省,4466642 ,0 ,4466642 
474,马提尼克,35,福建省,7240005 ,0 ,7240005 
474,马提尼克,36,江西省,6084218 ,0 ,6084218 
474,马提尼克,37,山东省,26742205 ,0 ,26742205 
474,马提尼克,41,河南省,4979445 ,0 ,4979445 
474,马提尼克,42,湖北省,564964 ,0 ,564964 
474,马提尼克,43,湖南省,1523791 ,0 ,1523791 
474,马提尼克,44,广东省,71187325 ,684702 ,71872027 
474,马提尼克,45,广西壮族自治区,331547 ,0 ,331547 
474,马提尼克,46,海南省,6065 ,0 ,6065 
474,马提尼克,50,重庆市,2778413 ,0 ,2778413 
474,马提尼克,51,四川省,3828751 ,0 ,3828751 
474,马提尼克,53,云南省,1347739 ,0 ,1347739 
474,马提尼克,61,陕西省,383 ,0 ,383 
478,毛里塔尼亚,11,北京市,84943173 ,239705541 ,324648714 
478,毛里塔尼亚,12,天津市,50517911 ,60164330 ,110682241 
478,毛里塔尼亚,13,河北省,64246110 ,3333708 ,67579818 
478,毛里塔尼亚,14,山西省,1353880 ,0 ,1353880 
478,毛里塔尼亚,15,内蒙古自治区,1800833 ,0 ,1800833 
478,毛里塔尼亚,21,辽宁省,27294370 ,20086812 ,47381182 
478,毛里塔尼亚,22,吉林省,5605302 ,0 ,5605302 
478,毛里塔尼亚,23,黑龙江省,2083768 ,0 ,2083768 
478,毛里塔尼亚,31,上海市,140757874 ,950956169 ,1091714043 
478,毛里塔尼亚,32,江苏省,292279160 ,718405799 ,1010684959 
478,毛里塔尼亚,33,浙江省,2206603507 ,838842755 ,3045446262 
478,毛里塔尼亚,34,安徽省,200549543 ,65 ,200549608 
478,毛里塔尼亚,35,福建省,186872546 ,319350754 ,506223300 
478,毛里塔尼亚,36,江西省,132566465 ,0 ,132566465 
478,毛里塔尼亚,37,山东省,317400991 ,288729916 ,606130907 
478,毛里塔尼亚,41,河南省,22919025 ,59727559 ,82646584 
478,毛里塔尼亚,42,湖北省,84149559 ,0 ,84149559 
478,毛里塔尼亚,43,湖南省,136727053 ,121732654 ,258459707 
478,毛里塔尼亚,44,广东省,372532963 ,863157375 ,1235690338 
478,毛里塔尼亚,45,广西壮族自治区,26247567 ,1251249011 ,1277496578 
478,毛里塔尼亚,46,海南省,2885481 ,506128019 ,509013500 
478,毛里塔尼亚,50,重庆市,36617451 ,1338 ,36618789 
478,毛里塔尼亚,51,四川省,65688094 ,19742039 ,85430133 
478,毛里塔尼亚,52,贵州省,9030160 ,0 ,9030160 
478,毛里塔尼亚,53,云南省,21635458 ,108541390 ,130176848 
478,毛里塔尼亚,61,陕西省,4284169 ,0 ,4284169 
478,毛里塔尼亚,62,甘肃省,67421 ,0 ,67421 
478,毛里塔尼亚,63,青海省,2044299 ,0 ,2044299 
478,毛里塔尼亚,64,宁夏回族自治区,3803839 ,0 ,3803839 
478,毛里塔尼亚,65,新疆维吾尔自治区,9773587 ,0 ,9773587 
480,毛里求斯,11,北京市,32694609 ,36992533 ,69687142 
480,毛里求斯,12,天津市,72772776 ,7873 ,72780649 
480,毛里求斯,13,河北省,123794730 ,15870 ,123810600 
480,毛里求斯,14,山西省,6870323 ,0 ,6870323 
480,毛里求斯,15,内蒙古自治区,6337191 ,0 ,6337191 
480,毛里求斯,21,辽宁省,7850293 ,134718 ,7985011 
480,毛里求斯,22,吉林省,603156 ,0 ,603156 
480,毛里求斯,23,黑龙江省,8818621 ,0 ,8818621 
480,毛里求斯,31,上海市,135709494 ,34647029 ,170356523 
480,毛里求斯,32,江苏省,402086004 ,120002 ,402206006 
480,毛里求斯,33,浙江省,954591018 ,65798668 ,1020389686 
480,毛里求斯,34,安徽省,79459283 ,16247 ,79475530 
480,毛里求斯,35,福建省,279562962 ,6603199 ,286166161 
480,毛里求斯,36,江西省,134411879 ,2268 ,134414147 
480,毛里求斯,37,山东省,556038518 ,292027 ,556330545 
480,毛里求斯,41,河南省,52655493 ,956 ,52656449 
480,毛里求斯,42,湖北省,125423142 ,56953 ,125480095 
480,毛里求斯,43,湖南省,181385449 ,4723 ,181390172 
480,毛里求斯,44,广东省,1088312049 ,13587800 ,1101899849 
480,毛里求斯,45,广西壮族自治区,26882669 ,0 ,26882669 
480,毛里求斯,46,海南省,3759095 ,1983314 ,5742409 
480,毛里求斯,50,重庆市,55650210 ,47384 ,55697594 
480,毛里求斯,51,四川省,93913069 ,345466 ,94258535 
480,毛里求斯,52,贵州省,29971574 ,0 ,29971574 
480,毛里求斯,53,云南省,84058472 ,0 ,84058472 
480,毛里求斯,61,陕西省,16304485 ,31890 ,16336375 
480,毛里求斯,62,甘肃省,9305 ,0 ,9305 
480,毛里求斯,63,青海省,637039 ,0 ,637039 
480,毛里求斯,64,宁夏回族自治区,1513939 ,0 ,1513939 
480,毛里求斯,65,新疆维吾尔自治区,2182505 ,0 ,2182505 
484,墨西哥,11,北京市,8443529278 ,6494809689 ,14938338967 
484,墨西哥,12,天津市,7865659032 ,1386013150 ,9251672182 
484,墨西哥,13,河北省,5213989829 ,244229698 ,5458219527 
484,墨西哥,14,山西省,2726114889 ,1043661426 ,3769776315 
484,墨西哥,15,内蒙古自治区,389735570 ,170754663 ,560490233 
484,墨西哥,21,辽宁省,3945985110 ,3380291296 ,7326276406 
484,墨西哥,22,吉林省,834335510 ,5290309185 ,6124644695 
484,墨西哥,23,黑龙江省,705966856 ,35301921 ,741268777 
484,墨西哥,31,上海市,27833705562 ,16642937101 ,44476642663 
484,墨西哥,32,江苏省,54237395942 ,10141250446 ,64378646388 
484,墨西哥,33,浙江省,66321381530 ,4997575827 ,71318957357 
484,墨西哥,34,安徽省,9434276836 ,1521941714 ,10956218550 
484,墨西哥,35,福建省,15261212285 ,3970768445 ,19231980730 
484,墨西哥,36,江西省,4457329785 ,2171845727 ,6629175512 
484,墨西哥,37,山东省,36188369271 ,2160375878 ,38348745149 
484,墨西哥,41,河南省,7091843438 ,8762109392 ,15853952830 
484,墨西哥,42,湖北省,8674653297 ,620238336 ,9294891633 
484,墨西哥,43,湖南省,6079235629 ,505010331 ,6584245960 
484,墨西哥,44,广东省,92569797710 ,11361945960 ,103931743670 
484,墨西哥,45,广西壮族自治区,4397796265 ,2442928733 ,6840724998 
484,墨西哥,46,海南省,909027313 ,47625816 ,956653129 
484,墨西哥,50,重庆市,9869028758 ,882893093 ,10751921851 
484,墨西哥,51,四川省,4072234791 ,1020666816 ,5092901607 
484,墨西哥,52,贵州省,359064899 ,30852519 ,389917418 
484,墨西哥,53,云南省,1565061681 ,1804130889 ,3369192570 
484,墨西哥,54,西藏自治区,3061538 ,373589 ,3435127 
484,墨西哥,61,陕西省,3934042024 ,190150261 ,4124192285 
484,墨西哥,62,甘肃省,170248533 ,46556082 ,216804615 
484,墨西哥,63,青海省,7896416 ,662009 ,8558425 
484,墨西哥,64,宁夏回族自治区,233459518 ,2159562 ,235619080 
484,墨西哥,65,新疆维吾尔自治区,232899455 ,3337153 ,236236608 
492,摩纳哥,11,北京市,10207 ,1225636 ,1235843 
492,摩纳哥,12,天津市,17471 ,2077110 ,2094581 
492,摩纳哥,13,河北省,39 ,2279 ,2318 
492,摩纳哥,14,山西省,35771 ,0 ,35771 
492,摩纳哥,15,内蒙古自治区,119337 ,0 ,119337 
492,摩纳哥,21,辽宁省,785092 ,17044 ,802136 
492,摩纳哥,22,吉林省,24243 ,80744 ,104987 
492,摩纳哥,23,黑龙江省,39 ,0 ,39 
492,摩纳哥,31,上海市,32372631 ,31525576 ,63898207 
492,摩纳哥,32,江苏省,5736110 ,2356273 ,8092383 
492,摩纳哥,33,浙江省,6502034 ,11052810 ,17554844 
492,摩纳哥,34,安徽省,959722 ,0 ,959722 
492,摩纳哥,35,福建省,813494 ,3226224 ,4039718 
492,摩纳哥,36,江西省,216487 ,0 ,216487 
492,摩纳哥,37,山东省,482434 ,2987 ,485421 
492,摩纳哥,41,河南省,0 ,390324 ,390324 
492,摩纳哥,42,湖北省,1260636 ,1123540 ,2384176 
492,摩纳哥,43,湖南省,587967 ,0 ,587967 
492,摩纳哥,44,广东省,14589971 ,19083498 ,33673469 
492,摩纳哥,45,广西壮族自治区,1004708 ,0 ,1004708 
492,摩纳哥,46,海南省,0 ,7172757 ,7172757 
492,摩纳哥,51,四川省,2841455 ,99750 ,2941205 
492,摩纳哥,53,云南省,692347 ,0 ,692347 
492,摩纳哥,61,陕西省,0 ,139017 ,139017 
492,摩纳哥,63,青海省,117 ,0 ,117 
492,摩纳哥,65,新疆维吾尔自治区,156 ,0 ,156 
496,蒙古,11,北京市,752893014 ,1142298013 ,1895191027 
496,蒙古,12,天津市,639065044 ,821688078 ,1460753122 
496,蒙古,13,河北省,609971912 ,2367475160 ,2977447072 
496,蒙古,14,山西省,69568162 ,444601538 ,514169700 
496,蒙古,15,内蒙古自治区,3877564482 ,27308422682 ,31185987164 
496,蒙古,21,辽宁省,242218298 ,20346136 ,262564434 
496,蒙古,22,吉林省,14651683 ,136088248 ,150739931 
496,蒙古,23,黑龙江省,452217997 ,19702571 ,471920568 
496,蒙古,31,上海市,443710458 ,5975443 ,449685901 
496,蒙古,32,江苏省,1033700104 ,383766626 ,1417466730 
496,蒙古,33,浙江省,833187966 ,95388120 ,928576086 
496,蒙古,34,安徽省,173052951 ,12792964 ,185845915 
496,蒙古,35,福建省,164152214 ,3310846132 ,3474998346 
496,蒙古,36,江西省,532084523 ,2223844 ,534308367 
496,蒙古,37,山东省,1556370084 ,40350206 ,1596720290 
496,蒙古,41,河南省,198390053 ,482817341 ,681207394 
496,蒙古,42,湖北省,269160957 ,385976764 ,655137721 
496,蒙古,43,湖南省,252950583 ,24098706 ,277049289 
496,蒙古,44,广东省,840803499 ,21037430 ,861840929 
496,蒙古,45,广西壮族自治区,54496429 ,0 ,54496429 
496,蒙古,46,海南省,14074069 ,57176214 ,71250283 
496,蒙古,50,重庆市,109704513 ,1159700018 ,1269404531 
496,蒙古,51,四川省,91509945 ,43297255 ,134807200 
496,蒙古,52,贵州省,7220907 ,0 ,7220907 
496,蒙古,53,云南省,9265638 ,2412000 ,11677638 
496,蒙古,61,陕西省,210843930 ,1425183 ,212269113 
496,蒙古,62,甘肃省,65827509 ,2315892928 ,2381720437 
496,蒙古,64,宁夏回族自治区,1993788 ,24969674 ,26963462 
496,蒙古,65,新疆维吾尔自治区,289131169 ,1789928724 ,2079059893 
498,摩尔多瓦,11,北京市,16186796 ,41575800 ,57762596 
498,摩尔多瓦,12,天津市,9783866 ,2851202 ,12635068 
498,摩尔多瓦,13,河北省,31894519 ,895960 ,32790479 
498,摩尔多瓦,14,山西省,490885 ,0 ,490885 
498,摩尔多瓦,15,内蒙古自治区,59985 ,0 ,59985 
498,摩尔多瓦,21,辽宁省,7787743 ,58273453 ,66061196 
498,摩尔多瓦,22,吉林省,675072 ,64369990 ,65045062 
498,摩尔多瓦,23,黑龙江省,3791070 ,1514462 ,5305532 
498,摩尔多瓦,31,上海市,38653072 ,147103904 ,185756976 
498,摩尔多瓦,32,江苏省,84307975 ,2650746 ,86958721 
498,摩尔多瓦,33,浙江省,267057746 ,23555908 ,290613654 
498,摩尔多瓦,34,安徽省,31978622 ,1785736 ,33764358 
498,摩尔多瓦,35,福建省,14914939 ,2218834 ,17133773 
498,摩尔多瓦,36,江西省,9811274 ,610 ,9811884 
498,摩尔多瓦,37,山东省,148221958 ,5376988 ,153598946 
498,摩尔多瓦,41,河南省,6155574 ,741408 ,6896982 
498,摩尔多瓦,42,湖北省,5894275 ,473848 ,6368123 
498,摩尔多瓦,43,湖南省,9410866 ,447166 ,9858032 
498,摩尔多瓦,44,广东省,265837854 ,12088800 ,277926654 
498,摩尔多瓦,45,广西壮族自治区,897632 ,1962 ,899594 
498,摩尔多瓦,46,海南省,19232 ,44440806 ,44460038 
498,摩尔多瓦,50,重庆市,19410393 ,470593 ,19880986 
498,摩尔多瓦,51,四川省,21476986 ,504773 ,21981759 
498,摩尔多瓦,52,贵州省,39 ,427566 ,427605 
498,摩尔多瓦,53,云南省,769423 ,0 ,769423 
498,摩尔多瓦,61,陕西省,4452806 ,7369247 ,11822053 
498,摩尔多瓦,62,甘肃省,400449 ,0 ,400449 
498,摩尔多瓦,64,宁夏回族自治区,45294 ,0 ,45294 
498,摩尔多瓦,65,新疆维吾尔自治区,13462061 ,234 ,13462295 
499,黑山,11,北京市,595473 ,1667299 ,2262772 
499,黑山,12,天津市,1177834 ,866125 ,2043959 
499,黑山,13,河北省,4198979 ,0 ,4198979 
499,黑山,14,山西省,918 ,0 ,918 
499,黑山,15,内蒙古自治区,375682 ,0 ,375682 
499,黑山,21,辽宁省,1457894 ,58444 ,1516338 
499,黑山,23,黑龙江省,9600198 ,0 ,9600198 
499,黑山,31,上海市,390899330 ,95375665 ,486274995 
499,黑山,32,江苏省,205729112 ,11265941 ,216995053 
499,黑山,33,浙江省,134002169 ,7032836 ,141035005 
499,黑山,34,安徽省,21048006 ,0 ,21048006 
499,黑山,35,福建省,13248561 ,121810457 ,135059018 
499,黑山,36,江西省,13632585 ,0 ,13632585 
499,黑山,37,山东省,211020617 ,765650 ,211786267 
499,黑山,41,河南省,2558004 ,0 ,2558004 
499,黑山,42,湖北省,4991364 ,980 ,4992344 
499,黑山,43,湖南省,5967641 ,0 ,5967641 
499,黑山,44,广东省,89674401 ,1342636 ,91017037 
499,黑山,45,广西壮族自治区,5476627 ,0 ,5476627 
499,黑山,46,海南省,24818181 ,0 ,24818181 
499,黑山,50,重庆市,8629163 ,0 ,8629163 
499,黑山,51,四川省,36610998 ,164625 ,36775623 
499,黑山,52,贵州省,11481431 ,0 ,11481431 
499,黑山,53,云南省,1276952 ,0 ,1276952 
499,黑山,61,陕西省,426189 ,959 ,427148 
499,黑山,65,新疆维吾尔自治区,3197791 ,0 ,3197791 
500,蒙特塞拉特,11,北京市,9284 ,23217 ,32501 
500,蒙特塞拉特,31,上海市,260276 ,0 ,260276 
500,蒙特塞拉特,32,江苏省,0 ,35092 ,35092 
500,蒙特塞拉特,35,福建省,12181 ,0 ,12181 
500,蒙特塞拉特,36,江西省,1486 ,0 ,1486 
500,蒙特塞拉特,37,山东省,124782 ,0 ,124782 
500,蒙特塞拉特,43,湖南省,39 ,0 ,39 
500,蒙特塞拉特,44,广东省,329497 ,3594 ,333091 
500,蒙特塞拉特,51,四川省,34 ,0 ,34 
504,摩洛哥,11,北京市,749537646 ,59402617 ,808940263 
504,摩洛哥,12,天津市,236921207 ,30655476 ,267576683 
504,摩洛哥,13,河北省,723670146 ,5832426 ,729502572 
504,摩洛哥,14,山西省,43671302 ,1371 ,43672673 
504,摩洛哥,15,内蒙古自治区,37834727 ,11759325 ,49594052 
504,摩洛哥,21,辽宁省,150332432 ,52419742 ,202752174 
504,摩洛哥,22,吉林省,26581896 ,77374250 ,103956146 
504,摩洛哥,23,黑龙江省,58445234 ,11561997 ,70007231 
504,摩洛哥,31,上海市,1649675202 ,1805275085 ,3454950287 
504,摩洛哥,32,江苏省,3104361084 ,280546074 ,3384907158 
504,摩洛哥,33,浙江省,8049980917 ,429997362 ,8479978279 
504,摩洛哥,34,安徽省,566379114 ,10388751 ,576767865 
504,摩洛哥,35,福建省,847784113 ,170918569 ,1018702682 
504,摩洛哥,36,江西省,787162993 ,23643310 ,810806303 
504,摩洛哥,37,山东省,1995873874 ,71586425 ,2067460299 
504,摩洛哥,41,河南省,294305824 ,237592 ,294543416 
504,摩洛哥,42,湖北省,572078738 ,44837462 ,616916200 
504,摩洛哥,43,湖南省,808932513 ,48715282 ,857647795 
504,摩洛哥,44,广东省,5796681179 ,1113447206 ,6910128385 
504,摩洛哥,45,广西壮族自治区,295475417 ,34265760 ,329741177 
504,摩洛哥,46,海南省,15638655 ,5677522 ,21316177 
504,摩洛哥,50,重庆市,571627173 ,35185791 ,606812964 
504,摩洛哥,51,四川省,422046221 ,56904394 ,478950615 
504,摩洛哥,52,贵州省,49469048 ,193241 ,49662289 
504,摩洛哥,53,云南省,398940594 ,311443 ,399252037 
504,摩洛哥,54,西藏自治区,0 ,1538170 ,1538170 
504,摩洛哥,61,陕西省,85365129 ,107187259 ,192552388 
504,摩洛哥,62,甘肃省,15209171 ,0 ,15209171 
504,摩洛哥,63,青海省,6401887 ,72956606 ,79358493 
504,摩洛哥,64,宁夏回族自治区,3637597 ,0 ,3637597 
504,摩洛哥,65,新疆维吾尔自治区,14033296 ,0 ,14033296 
508,莫桑比克,11,北京市,420468189 ,248119291 ,668587480 
508,莫桑比克,12,天津市,260325750 ,38771157 ,299096907 
508,莫桑比克,13,河北省,355117584 ,6547603 ,361665187 
508,莫桑比克,14,山西省,132956429 ,73253196 ,206209625 
508,莫桑比克,15,内蒙古自治区,31545632 ,0 ,31545632 
508,莫桑比克,21,辽宁省,56638352 ,50527908 ,107166260 
508,莫桑比克,22,吉林省,15857543 ,0 ,15857543 
508,莫桑比克,23,黑龙江省,26255000 ,2089173 ,28344173 
508,莫桑比克,31,上海市,169843573 ,451384858 ,621228431 
508,莫桑比克,32,江苏省,839061881 ,554032751 ,1393094632 
508,莫桑比克,33,浙江省,3743437204 ,856001950 ,4599439154 
508,莫桑比克,34,安徽省,254314257 ,180087061 ,434401318 
508,莫桑比克,35,福建省,1018967453 ,815727345 ,1834694798 
508,莫桑比克,36,江西省,583937044 ,6899759 ,590836803 
508,莫桑比克,37,山东省,2471587569 ,1018059078 ,3489646647 
508,莫桑比克,41,河南省,235950342 ,336539129 ,572489471 
508,莫桑比克,42,湖北省,338956323 ,97348719 ,436305042 
508,莫桑比克,43,湖南省,600058953 ,1620223 ,601679176 
508,莫桑比克,44,广东省,1814490037 ,334595213 ,2149085250 
508,莫桑比克,45,广西壮族自治区,106255203 ,368327029 ,474582232 
508,莫桑比克,46,海南省,43261373 ,107789568 ,151050941 
508,莫桑比克,50,重庆市,422867865 ,712955880 ,1135823745 
508,莫桑比克,51,四川省,386360722 ,160282326 ,546643048 
508,莫桑比克,52,贵州省,63475205 ,0 ,63475205 
508,莫桑比克,53,云南省,164869211 ,0 ,164869211 
508,莫桑比克,61,陕西省,200355644 ,51398797 ,251754441 
508,莫桑比克,62,甘肃省,2836040 ,0 ,2836040 
508,莫桑比克,64,宁夏回族自治区,3757253 ,0 ,3757253 
508,莫桑比克,65,新疆维吾尔自治区,13591648 ,0 ,13591648 
512,阿曼,11,北京市,457728218 ,114449164922 ,114906893140 
512,阿曼,12,天津市,763342347 ,1072553264 ,1835895611 
512,阿曼,13,河北省,494056291 ,1703894432 ,2197950723 
512,阿曼,14,山西省,73142302 ,55971540 ,129113842 
512,阿曼,15,内蒙古自治区,69392417 ,454061124 ,523453541 
512,阿曼,21,辽宁省,1337770001 ,4056195089 ,5393965090 
512,阿曼,22,吉林省,24656244 ,0 ,24656244 
512,阿曼,23,黑龙江省,18030257 ,0 ,18030257 
512,阿曼,31,上海市,1220705554 ,5177637063 ,6398342617 
512,阿曼,32,江苏省,2810529790 ,2190771421 ,5001301211 
512,阿曼,33,浙江省,3099231118 ,12361589509 ,15460820627 
512,阿曼,34,安徽省,507552205 ,12005321 ,519557526 
512,阿曼,35,福建省,679573980 ,1352248632 ,2031822612 
512,阿曼,36,江西省,349881930 ,1997 ,349883927 
512,阿曼,37,山东省,2557349311 ,23426296570 ,25983645881 
512,阿曼,41,河南省,708743536 ,1310225369 ,2018968905 
512,阿曼,42,湖北省,380124088 ,2769319 ,382893407 
512,阿曼,43,湖南省,652500014 ,783314345 ,1435814359 
512,阿曼,44,广东省,2990500141 ,6695071618 ,9685571759 
512,阿曼,45,广西壮族自治区,110281309 ,375514128 ,485795437 
512,阿曼,46,海南省,12734595 ,3363148436 ,3375883031 
512,阿曼,50,重庆市,214262774 ,778247 ,215041021 
512,阿曼,51,四川省,169841223 ,456149110 ,625990333 
512,阿曼,52,贵州省,18996684 ,0 ,18996684 
512,阿曼,53,云南省,200432088 ,325808315 ,526240403 
512,阿曼,54,西藏自治区,980 ,0 ,980 
512,阿曼,61,陕西省,457628942 ,310 ,457629252 
512,阿曼,62,甘肃省,73697102 ,39764 ,73736866 
512,阿曼,63,青海省,4196578 ,0 ,4196578 
512,阿曼,64,宁夏回族自治区,11694620 ,0 ,11694620 
512,阿曼,65,新疆维吾尔自治区,85560075 ,0 ,85560075 
516,纳米比亚,11,北京市,131758934 ,2174126156 ,2305885090 
516,纳米比亚,12,天津市,33970710 ,7066296 ,41037006 
516,纳米比亚,13,河北省,16765046 ,6763528 ,23528574 
516,纳米比亚,14,山西省,600770 ,0 ,600770 
516,纳米比亚,15,内蒙古自治区,8447229 ,0 ,8447229 
516,纳米比亚,21,辽宁省,37452879 ,120 ,37452999 
516,纳米比亚,23,黑龙江省,6777659 ,0 ,6777659 
516,纳米比亚,31,上海市,33238265 ,4671382 ,37909647 
516,纳米比亚,32,江苏省,173160761 ,132655445 ,305816206 
516,纳米比亚,33,浙江省,577807545 ,24974320 ,602781865 
516,纳米比亚,34,安徽省,89909954 ,173960 ,90083914 
516,纳米比亚,35,福建省,241723559 ,165758205 ,407481764 
516,纳米比亚,36,江西省,306825544 ,784749 ,307610293 
516,纳米比亚,37,山东省,298615199 ,31143682 ,329758881 
516,纳米比亚,41,河南省,19435382 ,0 ,19435382 
516,纳米比亚,42,湖北省,47412942 ,454258 ,47867200 
516,纳米比亚,43,湖南省,123362785 ,908812 ,124271597 
516,纳米比亚,44,广东省,210757062 ,53666397 ,264423459 
516,纳米比亚,45,广西壮族自治区,13367180 ,0 ,13367180 
516,纳米比亚,46,海南省,4942172 ,0 ,4942172 
516,纳米比亚,50,重庆市,31169846 ,0 ,31169846 
516,纳米比亚,51,四川省,63129227 ,15573 ,63144800 
516,纳米比亚,52,贵州省,57263049 ,0 ,57263049 
516,纳米比亚,53,云南省,90797974 ,24981 ,90822955 
516,纳米比亚,61,陕西省,48027997 ,101154633 ,149182630 
516,纳米比亚,62,甘肃省,4934618 ,0 ,4934618 
516,纳米比亚,65,新疆维吾尔自治区,14591186 ,0 ,14591186 
520,瑙鲁,11,北京市,12922410 ,156513 ,13078923 
520,瑙鲁,21,辽宁省,39 ,0 ,39 
520,瑙鲁,31,上海市,1660835 ,102829 ,1763664 
520,瑙鲁,32,江苏省,6484983 ,0 ,6484983 
520,瑙鲁,33,浙江省,15007382 ,2176 ,15009558 
520,瑙鲁,34,安徽省,22834 ,0 ,22834 
520,瑙鲁,35,福建省,2008473 ,3410 ,2011883 
520,瑙鲁,36,江西省,2255918 ,0 ,2255918 
520,瑙鲁,37,山东省,11906197 ,421099 ,12327296 
520,瑙鲁,41,河南省,351 ,0 ,351 
520,瑙鲁,42,湖北省,104492 ,0 ,104492 
520,瑙鲁,43,湖南省,5691422 ,0 ,5691422 
520,瑙鲁,44,广东省,16108579 ,12794 ,16121373 
520,瑙鲁,45,广西壮族自治区,26467 ,0 ,26467 
520,瑙鲁,50,重庆市,1079741 ,0 ,1079741 
520,瑙鲁,51,四川省,2312777 ,0 ,2312777 
520,瑙鲁,52,贵州省,39 ,0 ,39 
524,尼泊尔联邦民主共和国,11,北京市,295474076 ,13375238 ,308849314 
524,尼泊尔联邦民主共和国,12,天津市,51495297 ,149241 ,51644538 
524,尼泊尔联邦民主共和国,13,河北省,244075463 ,588961 ,244664424 
524,尼泊尔联邦民主共和国,14,山西省,12007932 ,0 ,12007932 
524,尼泊尔联邦民主共和国,15,内蒙古自治区,29311397 ,157 ,29311554 
524,尼泊尔联邦民主共和国,21,辽宁省,41600507 ,557237 ,42157744 
524,尼泊尔联邦民主共和国,22,吉林省,1141830 ,0 ,1141830 
524,尼泊尔联邦民主共和国,23,黑龙江省,15900614 ,3188525 ,19089139 
524,尼泊尔联邦民主共和国,31,上海市,204476072 ,20497399 ,224973471 
524,尼泊尔联邦民主共和国,32,江苏省,497109891 ,5604467 ,502714358 
524,尼泊尔联邦民主共和国,33,浙江省,1383947212 ,20161846 ,1404109058 
524,尼泊尔联邦民主共和国,34,安徽省,90662045 ,53100 ,90715145 
524,尼泊尔联邦民主共和国,35,福建省,189165908 ,393379 ,189559287 
524,尼泊尔联邦民主共和国,36,江西省,186679584 ,0 ,186679584 
524,尼泊尔联邦民主共和国,37,山东省,786259628 ,731846 ,786991474 
524,尼泊尔联邦民主共和国,41,河南省,139033558 ,305850 ,139339408 
524,尼泊尔联邦民主共和国,42,湖北省,325047869 ,15243 ,325063112 
524,尼泊尔联邦民主共和国,43,湖南省,254681954 ,1911658 ,256593612 
524,尼泊尔联邦民主共和国,44,广东省,1500647271 ,11680376 ,1512327647 
524,尼泊尔联邦民主共和国,45,广西壮族自治区,102067290 ,0 ,102067290 
524,尼泊尔联邦民主共和国,46,海南省,17421732 ,0 ,17421732 
524,尼泊尔联邦民主共和国,50,重庆市,202393212 ,0 ,202393212 
524,尼泊尔联邦民主共和国,51,四川省,349068212 ,31419749 ,380487961 
524,尼泊尔联邦民主共和国,52,贵州省,8754810 ,26272 ,8781082 
524,尼泊尔联邦民主共和国,53,云南省,58010814 ,1224940 ,59235754 
524,尼泊尔联邦民主共和国,54,西藏自治区,1179489817 ,421493 ,1179911310 
524,尼泊尔联邦民主共和国,61,陕西省,15473641 ,8012 ,15481653 
524,尼泊尔联邦民主共和国,62,甘肃省,132787460 ,0 ,132787460 
524,尼泊尔联邦民主共和国,63,青海省,7674537 ,197944 ,7872481 
524,尼泊尔联邦民主共和国,64,宁夏回族自治区,2478523 ,0 ,2478523 
524,尼泊尔联邦民主共和国,65,新疆维吾尔自治区,21290059 ,0 ,21290059 
528,荷兰,11,北京市,6611132495 ,6579537590 ,13190670085 
528,荷兰,12,天津市,4539950178 ,1280882055 ,5820832233 
528,荷兰,13,河北省,6708377398 ,495474131 ,7203851529 
528,荷兰,14,山西省,4733338899 ,25872287 ,4759211186 
528,荷兰,15,内蒙古自治区,1009867615 ,205896247 ,1215763862 
528,荷兰,21,辽宁省,5835161247 ,660864584 ,6496025831 
528,荷兰,22,吉林省,991454960 ,192278559 ,1183733519 
528,荷兰,23,黑龙江省,1304663628 ,44454017 ,1349117645 
528,荷兰,31,上海市,43851412988 ,17469768851 ,61321181839 
528,荷兰,32,江苏省,115935504156 ,7500835250 ,123436339406 
528,荷兰,33,浙江省,76790537226 ,3870809606 ,80661346832 
528,荷兰,34,安徽省,17473851086 ,3760081970 ,21233933056 
528,荷兰,35,福建省,25327664906 ,1379803747 ,26707468653 
528,荷兰,36,江西省,11175705565 ,140054850 ,11315760415 
528,荷兰,37,山东省,37318955962 ,2150592717 ,39469548679 
528,荷兰,41,河南省,17183675359 ,391213726 ,17574889085 
528,荷兰,42,湖北省,7640492556 ,1653025251 ,9293517807 
528,荷兰,43,湖南省,6034693220 ,2332985495 ,8367678715 
528,荷兰,44,广东省,123871395745 ,8967752258 ,132839148003 
528,荷兰,45,广西壮族自治区,2597637550 ,26077484 ,2623715034 
528,荷兰,46,海南省,5641352977 ,40578398 ,5681931375 
528,荷兰,50,重庆市,10282585509 ,424511805 ,10707097314 
528,荷兰,51,四川省,29331671381 ,553438023 ,29885109404 
528,荷兰,52,贵州省,474389018 ,8762590 ,483151608 
528,荷兰,53,云南省,2067047939 ,379733085 ,2446781024 
528,荷兰,54,西藏自治区,10120041 ,21679 ,10141720 
528,荷兰,61,陕西省,14084941293 ,270457907 ,14355399200 
528,荷兰,62,甘肃省,182152460 ,58156208 ,240308668 
528,荷兰,63,青海省,44413573 ,1530826 ,45944399 
528,荷兰,64,宁夏回族自治区,777797765 ,31514607 ,809312372 
528,荷兰,65,新疆维吾尔自治区,451242237 ,13497246 ,464739483 
533,阿鲁巴,11,北京市,897772 ,448 ,898220 
533,阿鲁巴,12,天津市,1530498 ,0 ,1530498 
533,阿鲁巴,13,河北省,3973561 ,0 ,3973561 
533,阿鲁巴,21,辽宁省,1176119 ,0 ,1176119 
533,阿鲁巴,31,上海市,12768558 ,1133 ,12769691 
533,阿鲁巴,32,江苏省,29422000 ,41 ,29422041 
533,阿鲁巴,33,浙江省,41430402 ,1740616 ,43171018 
533,阿鲁巴,34,安徽省,6875320 ,0 ,6875320 
533,阿鲁巴,35,福建省,6682164 ,317 ,6682481 
533,阿鲁巴,36,江西省,20488784 ,0 ,20488784 
533,阿鲁巴,37,山东省,22287835 ,195344 ,22483179 
533,阿鲁巴,41,河南省,1124628 ,0 ,1124628 
533,阿鲁巴,42,湖北省,10081590 ,0 ,10081590 
533,阿鲁巴,43,湖南省,13713644 ,0 ,13713644 
533,阿鲁巴,44,广东省,86334398 ,2016 ,86336414 
533,阿鲁巴,45,广西壮族自治区,11366942 ,0 ,11366942 
533,阿鲁巴,50,重庆市,15525702 ,0 ,15525702 
533,阿鲁巴,51,四川省,3444569 ,0 ,3444569 
533,阿鲁巴,52,贵州省,39 ,0 ,39 
533,阿鲁巴,53,云南省,327956 ,0 ,327956 
533,阿鲁巴,61,陕西省,1948411 ,0 ,1948411 
540,新喀里多尼亚,11,北京市,1989944 ,131179730 ,133169674 
540,新喀里多尼亚,12,天津市,23272354 ,0 ,23272354 
540,新喀里多尼亚,13,河北省,18570001 ,0 ,18570001 
540,新喀里多尼亚,14,山西省,679571 ,3031157427 ,3031836998 
540,新喀里多尼亚,15,内蒙古自治区,60086 ,0 ,60086 
540,新喀里多尼亚,21,辽宁省,13338201 ,0 ,13338201 
540,新喀里多尼亚,22,吉林省,15550161 ,0 ,15550161 
540,新喀里多尼亚,23,黑龙江省,1644677 ,0 ,1644677 
540,新喀里多尼亚,31,上海市,71465870 ,967384027 ,1038849897 
540,新喀里多尼亚,32,江苏省,160337381 ,1430723839 ,1591061220 
540,新喀里多尼亚,33,浙江省,133709549 ,1319604245 ,1453313794 
540,新喀里多尼亚,34,安徽省,24764076 ,0 ,24764076 
540,新喀里多尼亚,35,福建省,36440263 ,610467330 ,646907593 
540,新喀里多尼亚,36,江西省,9242727 ,0 ,9242727 
540,新喀里多尼亚,37,山东省,116668968 ,128820353 ,245489321 
540,新喀里多尼亚,41,河南省,11090604 ,0 ,11090604 
540,新喀里多尼亚,42,湖北省,16391912 ,0 ,16391912 
540,新喀里多尼亚,43,湖南省,25072543 ,559251408 ,584323951 
540,新喀里多尼亚,44,广东省,128651579 ,561833067 ,690484646 
540,新喀里多尼亚,45,广西壮族自治区,5916369 ,160752951 ,166669320 
540,新喀里多尼亚,50,重庆市,17331361 ,61506 ,17392867 
540,新喀里多尼亚,51,四川省,8033977 ,0 ,8033977 
540,新喀里多尼亚,52,贵州省,295620 ,504538953 ,504834573 
540,新喀里多尼亚,53,云南省,687342 ,0 ,687342 
540,新喀里多尼亚,61,陕西省,2911022 ,0 ,2911022 
540,新喀里多尼亚,62,甘肃省,0 ,85449217 ,85449217 
540,新喀里多尼亚,63,青海省,0 ,32009785 ,32009785 
540,新喀里多尼亚,64,宁夏回族自治区,3660755 ,0 ,3660755 
540,新喀里多尼亚,65,新疆维吾尔自治区,6398451 ,0 ,6398451 
548,瓦努阿图,11,北京市,42136564 ,4498 ,42141062 
548,瓦努阿图,12,天津市,5535163 ,0 ,5535163 
548,瓦努阿图,13,河北省,6153809 ,0 ,6153809 
548,瓦努阿图,14,山西省,1494589 ,0 ,1494589 
548,瓦努阿图,21,辽宁省,912201 ,320 ,912521 
548,瓦努阿图,23,黑龙江省,360616 ,0 ,360616 
548,瓦努阿图,31,上海市,11290497 ,60760 ,11351257 
548,瓦努阿图,32,江苏省,21467981 ,0 ,21467981 
548,瓦努阿图,33,浙江省,159524346 ,0 ,159524346 
548,瓦努阿图,34,安徽省,4938970 ,0 ,4938970 
548,瓦努阿图,35,福建省,56384968 ,35751293 ,92136261 
548,瓦努阿图,36,江西省,12905327 ,0 ,12905327 
548,瓦努阿图,37,山东省,35647142 ,0 ,35647142 
548,瓦努阿图,41,河南省,2702225 ,0 ,2702225 
548,瓦努阿图,42,湖北省,17778540 ,0 ,17778540 
548,瓦努阿图,43,湖南省,12849060 ,0 ,12849060 
548,瓦努阿图,44,广东省,45213790 ,3256279 ,48470069 
548,瓦努阿图,46,海南省,373876 ,0 ,373876 
548,瓦努阿图,50,重庆市,3454885 ,0 ,3454885 
548,瓦努阿图,51,四川省,19037551 ,0 ,19037551 
548,瓦努阿图,52,贵州省,39 ,0 ,39 
548,瓦努阿图,53,云南省,3040773 ,0 ,3040773 
548,瓦努阿图,61,陕西省,24576 ,18804952 ,18829528 
548,瓦努阿图,65,新疆维吾尔自治区,287318 ,0 ,287318 
554,新西兰,11,北京市,494790231 ,4301516042 ,4796306273 
554,新西兰,12,天津市,731794299 ,7655721815 ,8387516114 
554,新西兰,13,河北省,1058624369 ,880215260 ,1938839629 
554,新西兰,14,山西省,113177018 ,5443309 ,118620327 
554,新西兰,15,内蒙古自治区,65735597 ,2576881384 ,2642616981 
554,新西兰,21,辽宁省,538335326 ,2478417216 ,3016752542 
554,新西兰,22,吉林省,43061409 ,66549419 ,109610828 
554,新西兰,23,黑龙江省,51197541 ,3386807153 ,3438004694 
554,新西兰,31,上海市,4790045677 ,14279672449 ,19069718126 
554,新西兰,32,江苏省,6587456107 ,3950733038 ,10538189145 
554,新西兰,33,浙江省,7936769517 ,6533922970 ,14470692487 
554,新西兰,34,安徽省,844945805 ,1971118231 ,2816064036 
554,新西兰,35,福建省,2005264330 ,9788154591 ,11793418921 
554,新西兰,36,江西省,783998433 ,160792255 ,944790688 
554,新西兰,37,山东省,4615447248 ,7538239130 ,12153686378 
554,新西兰,41,河南省,528808531 ,301397313 ,830205844 
554,新西兰,42,湖北省,622056191 ,305533994 ,927590185 
554,新西兰,43,湖南省,792756260 ,1640320498 ,2433076758 
554,新西兰,44,广东省,9963270589 ,9129374078 ,19092644667 
554,新西兰,45,广西壮族自治区,321743780 ,224908487 ,546652267 
554,新西兰,46,海南省,38729035 ,1201877275 ,1240606310 
554,新西兰,50,重庆市,993004546 ,1091790393 ,2084794939 
554,新西兰,51,四川省,593535760 ,1049077897 ,1642613657 
554,新西兰,52,贵州省,765832622 ,165837250 ,931669872 
554,新西兰,53,云南省,359009395 ,10239920 ,369249315 
554,新西兰,54,西藏自治区,1096 ,0 ,1096 
554,新西兰,61,陕西省,158286869 ,37936373 ,196223242 
554,新西兰,62,甘肃省,12862272 ,11128618 ,23990890 
554,新西兰,63,青海省,46465361 ,46850441 ,93315802 
554,新西兰,64,宁夏回族自治区,29704045 ,75792005 ,105496050 
554,新西兰,65,新疆维吾尔自治区,31045100 ,0 ,31045100 
558,尼加拉瓜,11,北京市,51576490 ,20385176 ,71961666 
558,尼加拉瓜,12,天津市,33200422 ,9825 ,33210247 
558,尼加拉瓜,13,河北省,51543680 ,367834 ,51911514 
558,尼加拉瓜,14,山西省,2170698 ,0 ,2170698 
558,尼加拉瓜,15,内蒙古自治区,4097217 ,0 ,4097217 
558,尼加拉瓜,21,辽宁省,54313733 ,703568 ,55017301 
558,尼加拉瓜,22,吉林省,4562115 ,0 ,4562115 
558,尼加拉瓜,23,黑龙江省,2362522 ,0 ,2362522 
558,尼加拉瓜,31,上海市,161384035 ,10287869 ,171671904 
558,尼加拉瓜,32,江苏省,574796381 ,1801404 ,576597785 
558,尼加拉瓜,33,浙江省,818274176 ,20448304 ,838722480 
558,尼加拉瓜,34,安徽省,48831368 ,3071411 ,51902779 
558,尼加拉瓜,35,福建省,142572512 ,1923951 ,144496463 
558,尼加拉瓜,36,江西省,105835489 ,1364 ,105836853 
558,尼加拉瓜,37,山东省,399794420 ,103715523 ,503509943 
558,尼加拉瓜,41,河南省,29520488 ,160 ,29520648 
558,尼加拉瓜,42,湖北省,31935300 ,10763 ,31946063 
558,尼加拉瓜,43,湖南省,62197484 ,6875946 ,69073430 
558,尼加拉瓜,44,广东省,909002901 ,11142563 ,920145464 
558,尼加拉瓜,45,广西壮族自治区,57117977 ,17199071 ,74317048 
558,尼加拉瓜,50,重庆市,111429345 ,0 ,111429345 
558,尼加拉瓜,51,四川省,27357053 ,57300 ,27414353 
558,尼加拉瓜,52,贵州省,3964437 ,0 ,3964437 
558,尼加拉瓜,53,云南省,6261672 ,0 ,6261672 
558,尼加拉瓜,61,陕西省,4462663 ,0 ,4462663 
558,尼加拉瓜,64,宁夏回族自治区,1356834 ,0 ,1356834 
558,尼加拉瓜,65,新疆维吾尔自治区,4036626 ,0 ,4036626 
562,尼日尔,11,北京市,1189627491 ,259426673 ,1449054164 
562,尼日尔,12,天津市,286616202 ,138959802 ,425576004 
562,尼日尔,13,河北省,271273972 ,5127533 ,276401505 
562,尼日尔,14,山西省,4566243 ,0 ,4566243 
562,尼日尔,21,辽宁省,1139635 ,14863166 ,16002801 
562,尼日尔,22,吉林省,548 ,0 ,548 
562,尼日尔,23,黑龙江省,1032216 ,1811822 ,2844038 
562,尼日尔,31,上海市,18974646 ,32146340 ,51120986 
562,尼日尔,32,江苏省,311256541 ,45516199 ,356772740 
562,尼日尔,33,浙江省,177337017 ,125404857 ,302741874 
562,尼日尔,34,安徽省,13282768 ,492842134 ,506124902 
562,尼日尔,35,福建省,101589231 ,83843610 ,185432841 
562,尼日尔,36,江西省,7703122 ,0 ,7703122 
562,尼日尔,37,山东省,222066291 ,447712579 ,669778870 
562,尼日尔,41,河南省,43185535 ,28282758 ,71468293 
562,尼日尔,42,湖北省,56536118 ,81219471 ,137755589 
562,尼日尔,43,湖南省,20357091 ,5069986 ,25427077 
562,尼日尔,44,广东省,213409222 ,33979663 ,247388885 
562,尼日尔,45,广西壮族自治区,31255526 ,48986973 ,80242499 
562,尼日尔,46,海南省,229231 ,0 ,229231 
562,尼日尔,50,重庆市,54095908 ,384405 ,54480313 
562,尼日尔,51,四川省,129223 ,1809361 ,1938584 
562,尼日尔,61,陕西省,2125134 ,0 ,2125134 
562,尼日尔,62,甘肃省,20523120 ,0 ,20523120 
562,尼日尔,65,新疆维吾尔自治区,1648511 ,0 ,1648511 
566,尼日利亚,11,北京市,1789980046 ,2393244428 ,4183224474 
566,尼日利亚,12,天津市,1231358340 ,22177820 ,1253536160 
566,尼日利亚,13,河北省,3301097988 ,73955746 ,3375053734 
566,尼日利亚,14,山西省,73918079 ,124645 ,74042724 
566,尼日利亚,15,内蒙古自治区,565788158 ,4238352 ,570026510 
566,尼日利亚,21,辽宁省,400687902 ,14737905 ,415425807 
566,尼日利亚,22,吉林省,116664815 ,895790 ,117560605 
566,尼日利亚,23,黑龙江省,62426067 ,48063300 ,110489367 
566,尼日利亚,31,上海市,3089558772 ,541875322 ,3631434094 
566,尼日利亚,32,江苏省,8630847974 ,70325721 ,8701173695 
566,尼日利亚,33,浙江省,25066628431 ,954855941 ,26021484372 
566,尼日利亚,34,安徽省,2042515803 ,231895967 ,2274411770 
566,尼日利亚,35,福建省,7527390934 ,805825828 ,8333216762 
566,尼日利亚,36,江西省,4169728955 ,578925523 ,4748654478 
566,尼日利亚,37,山东省,12314411520 ,382515260 ,12696926780 
566,尼日利亚,41,河南省,3045594725 ,55818154 ,3101412879 
566,尼日利亚,42,湖北省,2101661965 ,20008730 ,2121670695 
566,尼日利亚,43,湖南省,4872907817 ,172671356 ,5045579173 
566,尼日利亚,44,广东省,18481601887 ,1651895851 ,20133497738 
566,尼日利亚,45,广西壮族自治区,1201171591 ,50525665 ,1251697256 
566,尼日利亚,46,海南省,445399396 ,261618940 ,707018336 
566,尼日利亚,50,重庆市,3027422023 ,3972761 ,3031394784 
566,尼日利亚,51,四川省,4161123478 ,18600592 ,4179724070 
566,尼日利亚,52,贵州省,188277288 ,0 ,188277288 
566,尼日利亚,53,云南省,516336329 ,31338413 ,547674742 
566,尼日利亚,54,西藏自治区,1890098 ,0 ,1890098 
566,尼日利亚,61,陕西省,664897275 ,33409706 ,698306981 
566,尼日利亚,62,甘肃省,17328436 ,0 ,17328436 
566,尼日利亚,63,青海省,26265904 ,0 ,26265904 
566,尼日利亚,64,宁夏回族自治区,31834317 ,3905 ,31838222 
566,尼日利亚,65,新疆维吾尔自治区,411107095 ,0 ,411107095 
574,诺福克岛,12,天津市,172095 ,0 ,172095 
574,诺福克岛,31,上海市,234 ,0 ,234 
574,诺福克岛,32,江苏省,44797 ,0 ,44797 
574,诺福克岛,33,浙江省,2135644 ,0 ,2135644 
574,诺福克岛,34,安徽省,719118 ,0 ,719118 
574,诺福克岛,35,福建省,234599 ,0 ,234599 
574,诺福克岛,37,山东省,2052081 ,0 ,2052081 
574,诺福克岛,42,湖北省,390630 ,0 ,390630 
574,诺福克岛,44,广东省,1819664 ,690 ,1820354 
574,诺福克岛,52,贵州省,78 ,0 ,78 
574,诺福克岛,53,云南省,1005247 ,0 ,1005247 
578,挪威,11,北京市,389991575 ,12059301579 ,12449293154 
578,挪威,12,天津市,289273984 ,564232170 ,853506154 
578,挪威,13,河北省,231879143 ,1554417438 ,1786296581 
578,挪威,14,山西省,69835828 ,6370 ,69842198 
578,挪威,15,内蒙古自治区,12458520 ,63020773 ,75479293 
578,挪威,21,辽宁省,260275528 ,625083401 ,885358929 
578,挪威,22,吉林省,566368664 ,76239521 ,642608185 
578,挪威,23,黑龙江省,25946694 ,13153723 ,39100417 
578,挪威,31,上海市,1820965667 ,4836548554 ,6657514221 
578,挪威,32,江苏省,3342560756 ,1360382615 ,4702943371 
578,挪威,33,浙江省,5046065125 ,1355435018 ,6401500143 
578,挪威,34,安徽省,1044488125 ,46127447 ,1090615572 
578,挪威,35,福建省,1398914781 ,326171845 ,1725086626 
578,挪威,36,江西省,230183167 ,390051839 ,620235006 
578,挪威,37,山东省,3354344973 ,15874181491 ,19228526464 
578,挪威,41,河南省,443669830 ,17254939 ,460924769 
578,挪威,42,湖北省,221833337 ,186496470 ,408329807 
578,挪威,43,湖南省,149630668 ,76934019 ,226564687 
578,挪威,44,广东省,3790552243 ,1916201138 ,5706753381 
578,挪威,45,广西壮族自治区,78825745 ,4396106 ,83221851 
578,挪威,46,海南省,92111661 ,2259542 ,94371203 
578,挪威,50,重庆市,97974897 ,49162346 ,147137243 
578,挪威,51,四川省,263117446 ,168187238 ,431304684 
578,挪威,52,贵州省,31047147 ,10078 ,31057225 
578,挪威,53,云南省,10400463 ,27788652 ,38189115 
578,挪威,54,西藏自治区,3173128 ,0 ,3173128 
578,挪威,61,陕西省,82096263 ,33563603 ,115659866 
578,挪威,62,甘肃省,6677436 ,300614 ,6978050 
578,挪威,63,青海省,31449 ,577191 ,608640 
578,挪威,64,宁夏回族自治区,49152491 ,31831239 ,80983730 
578,挪威,65,新疆维吾尔自治区,24881806 ,1159830 ,26041636 
583,密克罗尼西亚联邦,11,北京市,6867571 ,31894 ,6899465 
583,密克罗尼西亚联邦,12,天津市,1180696 ,0 ,1180696 
583,密克罗尼西亚联邦,13,河北省,34256411 ,0 ,34256411 
583,密克罗尼西亚联邦,21,辽宁省,1118158 ,0 ,1118158 
583,密克罗尼西亚联邦,31,上海市,255841 ,52049 ,307890 
583,密克罗尼西亚联邦,32,江苏省,11592842 ,649 ,11593491 
583,密克罗尼西亚联邦,33,浙江省,35983558 ,5243 ,35988801 
583,密克罗尼西亚联邦,34,安徽省,653051 ,0 ,653051 
583,密克罗尼西亚联邦,35,福建省,15809099 ,467319 ,16276418 
583,密克罗尼西亚联邦,36,江西省,4166212 ,0 ,4166212 
583,密克罗尼西亚联邦,37,山东省,19949823 ,3754 ,19953577 
583,密克罗尼西亚联邦,41,河南省,926447 ,0 ,926447 
583,密克罗尼西亚联邦,42,湖北省,887686 ,0 ,887686 
583,密克罗尼西亚联邦,43,湖南省,5030264 ,0 ,5030264 
583,密克罗尼西亚联邦,44,广东省,19215726 ,27368 ,19243094 
583,密克罗尼西亚联邦,45,广西壮族自治区,1448572 ,0 ,1448572 
583,密克罗尼西亚联邦,50,重庆市,1453084 ,0 ,1453084 
583,密克罗尼西亚联邦,51,四川省,1033307 ,1840 ,1035147 
583,密克罗尼西亚联邦,52,贵州省,1616689 ,0 ,1616689 
583,密克罗尼西亚联邦,61,陕西省,202264 ,5495 ,207759 
584,马绍尔群岛,11,北京市,1576923671 ,480 ,1576924151 
584,马绍尔群岛,12,天津市,468017453 ,0 ,468017453 
584,马绍尔群岛,13,河北省,56368470 ,0 ,56368470 
584,马绍尔群岛,21,辽宁省,533111100 ,0 ,533111100 
584,马绍尔群岛,31,上海市,900044056 ,23671 ,900067727 
584,马绍尔群岛,32,江苏省,5696658779 ,0 ,5696658779 
584,马绍尔群岛,33,浙江省,6609124656 ,407989 ,6609532645 
584,马绍尔群岛,34,安徽省,5977287 ,0 ,5977287 
584,马绍尔群岛,35,福建省,163155594 ,0 ,163155594 
584,马绍尔群岛,36,江西省,17409882 ,0 ,17409882 
584,马绍尔群岛,37,山东省,325345443 ,0 ,325345443 
584,马绍尔群岛,41,河南省,2429718 ,0 ,2429718 
584,马绍尔群岛,42,湖北省,185405860 ,1262 ,185407122 
584,马绍尔群岛,43,湖南省,9546912 ,0 ,9546912 
584,马绍尔群岛,44,广东省,476593986 ,276 ,476594262 
584,马绍尔群岛,45,广西壮族自治区,818371 ,0 ,818371 
584,马绍尔群岛,46,海南省,4148265 ,0 ,4148265 
584,马绍尔群岛,50,重庆市,3979584 ,0 ,3979584 
584,马绍尔群岛,51,四川省,1565641 ,0 ,1565641 
584,马绍尔群岛,53,云南省,213276 ,0 ,213276 
584,马绍尔群岛,61,陕西省,1514733 ,0 ,1514733 
584,马绍尔群岛,62,甘肃省,1204910 ,0 ,1204910 
585,帕劳,11,北京市,14518730 ,7334 ,14526064 
585,帕劳,12,天津市,1461080 ,0 ,1461080 
585,帕劳,13,河北省,605078 ,0 ,605078 
585,帕劳,21,辽宁省,531133 ,789 ,531922 
585,帕劳,31,上海市,289141 ,654346 ,943487 
585,帕劳,32,江苏省,8649241 ,50077 ,8699318 
585,帕劳,33,浙江省,164095697 ,5728 ,164101425 
585,帕劳,34,安徽省,651001 ,0 ,651001 
585,帕劳,35,福建省,2214950 ,947 ,2215897 
585,帕劳,36,江西省,2839939 ,0 ,2839939 
585,帕劳,37,山东省,11258256 ,0 ,11258256 
585,帕劳,41,河南省,85616 ,0 ,85616 
585,帕劳,42,湖北省,1375436 ,0 ,1375436 
585,帕劳,43,湖南省,4585378 ,0 ,4585378 
585,帕劳,44,广东省,43880430 ,266297 ,44146727 
585,帕劳,45,广西壮族自治区,3342256 ,0 ,3342256 
585,帕劳,50,重庆市,1764164 ,0 ,1764164 
585,帕劳,51,四川省,71045 ,0 ,71045 
585,帕劳,53,云南省,8896023 ,0 ,8896023 
586,巴基斯坦,11,北京市,8532915412 ,2915531271 ,11448446683 
586,巴基斯坦,12,天津市,1426960946 ,139392953 ,1566353899 
586,巴基斯坦,13,河北省,2313456700 ,148177161 ,2461633861 
586,巴基斯坦,14,山西省,212521036 ,86992381 ,299513417 
586,巴基斯坦,15,内蒙古自治区,176519528 ,79593747 ,256113275 
586,巴基斯坦,21,辽宁省,2230034166 ,152312913 ,2382347079 
586,巴基斯坦,22,吉林省,337816989 ,29367184 ,367184173 
586,巴基斯坦,23,黑龙江省,267814770 ,4969338 ,272784108 
586,巴基斯坦,31,上海市,4219762711 ,1130572841 ,5350335552 
586,巴基斯坦,32,江苏省,12344430007 ,769392231 ,13113822238 
586,巴基斯坦,33,浙江省,29630857890 ,4418853652 ,34049711542 
586,巴基斯坦,34,安徽省,2954056614 ,942727907 ,3896784521 
586,巴基斯坦,35,福建省,5980039838 ,1345272077 ,7325311915 
586,巴基斯坦,36,江西省,3662819100 ,404886454 ,4067705554 
586,巴基斯坦,37,山东省,9677351166 ,616212374 ,10293563540 
586,巴基斯坦,41,河南省,1207364170 ,64511899 ,1271876069 
586,巴基斯坦,42,湖北省,3090514612 ,43073753 ,3133588365 
586,巴基斯坦,43,湖南省,2146437504 ,136831941 ,2283269445 
586,巴基斯坦,44,广东省,15068463111 ,2291278908 ,17359742019 
586,巴基斯坦,45,广西壮族自治区,320980283 ,429856676 ,750836959 
586,巴基斯坦,46,海南省,40875582 ,286287679 ,327163261 
586,巴基斯坦,50,重庆市,3379267740 ,10469103 ,3389736843 
586,巴基斯坦,51,四川省,2379895096 ,78583281 ,2458478377 
586,巴基斯坦,52,贵州省,165821834 ,5890189 ,171712023 
586,巴基斯坦,53,云南省,367191899 ,67638444 ,434830343 
586,巴基斯坦,54,西藏自治区,9416264 ,0 ,9416264 
586,巴基斯坦,61,陕西省,788049802 ,170376427 ,958426229 
586,巴基斯坦,62,甘肃省,67261120 ,7171 ,67268291 
586,巴基斯坦,63,青海省,92025916 ,0 ,92025916 
586,巴基斯坦,64,宁夏回族自治区,89839072 ,679 ,89839751 
586,巴基斯坦,65,新疆维吾尔自治区,1601251505 ,23696134 ,1624947639 
591,巴拿马,11,北京市,6232462390 ,879663437 ,7112125827 
591,巴拿马,12,天津市,1346187016 ,32620393 ,1378807409 
591,巴拿马,13,河北省,558168152 ,4281 ,558172433 
591,巴拿马,14,山西省,10553571 ,177310568 ,187864139 
591,巴拿马,15,内蒙古自治区,21566155 ,184379938 ,205946093 
591,巴拿马,21,辽宁省,1309845957 ,3079908 ,1312925865 
591,巴拿马,22,吉林省,6162262 ,0 ,6162262 
591,巴拿马,23,黑龙江省,37206507 ,1760592 ,38967099 
591,巴拿马,31,上海市,3427214758 ,379838718 ,3807053476 
591,巴拿马,32,江苏省,5136046862 ,10905333 ,5146952195 
591,巴拿马,33,浙江省,18310759811 ,1069481558 ,19380241369 
591,巴拿马,34,安徽省,704035494 ,993328758 ,1697364252 
591,巴拿马,35,福建省,4103073247 ,10735826 ,4113809073 
591,巴拿马,36,江西省,1352527959 ,183871581 ,1536399540 
591,巴拿马,37,山东省,3877605646 ,344966372 ,4222572018 
591,巴拿马,41,河南省,319590089 ,143168328 ,462758417 
591,巴拿马,42,湖北省,1229237923 ,143430231 ,1372668154 
591,巴拿马,43,湖南省,1501466199 ,178349592 ,1679815791 
591,巴拿马,44,广东省,12232444411 ,45176438 ,12277620849 
591,巴拿马,45,广西壮族自治区,393092467 ,1261104416 ,1654196883 
591,巴拿马,46,海南省,36495503 ,172099721 ,208595224 
591,巴拿马,50,重庆市,1152276205 ,12232378 ,1164508583 
591,巴拿马,51,四川省,376650204 ,4292848 ,380943052 
591,巴拿马,52,贵州省,99009262 ,0 ,99009262 
591,巴拿马,53,云南省,460287160 ,377305186 ,837592346 
591,巴拿马,61,陕西省,46571267 ,0 ,46571267 
591,巴拿马,62,甘肃省,4196761 ,0 ,4196761 
591,巴拿马,63,青海省,969925 ,0 ,969925 
591,巴拿马,64,宁夏回族自治区,12884786 ,0 ,12884786 
591,巴拿马,65,新疆维吾尔自治区,45127961 ,0 ,45127961 
598,巴布亚新几内亚,11,北京市,620758115 ,12615042692 ,13235800807 
598,巴布亚新几内亚,12,天津市,136188390 ,42669229 ,178857619 
598,巴布亚新几内亚,13,河北省,129690964 ,21398105 ,151089069 
598,巴布亚新几内亚,14,山西省,3181830 ,44394 ,3226224 
598,巴布亚新几内亚,15,内蒙古自治区,16236403 ,0 ,16236403 
598,巴布亚新几内亚,21,辽宁省,110138086 ,83 ,110138169 
598,巴布亚新几内亚,22,吉林省,528292 ,0 ,528292 
598,巴布亚新几内亚,23,黑龙江省,5115135 ,0 ,5115135 
598,巴布亚新几内亚,31,上海市,233649531 ,138069324 ,371718855 
598,巴布亚新几内亚,32,江苏省,549295287 ,2485573950 ,3034869237 
598,巴布亚新几内亚,33,浙江省,1934463404 ,1275423799 ,3209887203 
598,巴布亚新几内亚,34,安徽省,98811641 ,150 ,98811791 
598,巴布亚新几内亚,35,福建省,385096783 ,150208610 ,535305393 
598,巴布亚新几内亚,36,江西省,170202847 ,10504583 ,180707430 
598,巴布亚新几内亚,37,山东省,719478256 ,22120 ,719500376 
598,巴布亚新几内亚,41,河南省,42260563 ,2371 ,42262934 
598,巴布亚新几内亚,42,湖北省,85185587 ,213642002 ,298827589 
598,巴布亚新几内亚,43,湖南省,125230673 ,0 ,125230673 
598,巴布亚新几内亚,44,广东省,1103511495 ,636068540 ,1739580035 
598,巴布亚新几内亚,45,广西壮族自治区,26652367 ,0 ,26652367 
598,巴布亚新几内亚,46,海南省,1954001 ,0 ,1954001 
598,巴布亚新几内亚,50,重庆市,54017249 ,1590573 ,55607822 
598,巴布亚新几内亚,51,四川省,196066623 ,24729082 ,220795705 
598,巴布亚新几内亚,52,贵州省,15687512 ,0 ,15687512 
598,巴布亚新几内亚,53,云南省,57494308 ,66687208 ,124181516 
598,巴布亚新几内亚,61,陕西省,13142611 ,0 ,13142611 
598,巴布亚新几内亚,64,宁夏回族自治区,1546773 ,0 ,1546773 
598,巴布亚新几内亚,65,新疆维吾尔自治区,6153098 ,0 ,6153098 
600,巴拉圭,11,北京市,152291862 ,1373928 ,153665790 
600,巴拉圭,12,天津市,68650316 ,1677098 ,70327414 
600,巴拉圭,13,河北省,99547952 ,2461281 ,102009233 
600,巴拉圭,14,山西省,3177599 ,0 ,3177599 
600,巴拉圭,15,内蒙古自治区,21871375 ,0 ,21871375 
600,巴拉圭,21,辽宁省,67668042 ,8057 ,67676099 
600,巴拉圭,22,吉林省,979055 ,0 ,979055 
600,巴拉圭,23,黑龙江省,8107116 ,0 ,8107116 
600,巴拉圭,31,上海市,515686112 ,13339814 ,529025926 
600,巴拉圭,32,江苏省,1350880857 ,2118097 ,1352998954 
600,巴拉圭,33,浙江省,1829282691 ,387714391 ,2216997082 
600,巴拉圭,34,安徽省,191543592 ,7645003 ,199188595 
600,巴拉圭,35,福建省,266747413 ,4799120 ,271546533 
600,巴拉圭,36,江西省,142669234 ,4765356 ,147434590 
600,巴拉圭,37,山东省,1614627353 ,2134675 ,1616762028 
600,巴拉圭,41,河南省,88831630 ,518031 ,89349661 
600,巴拉圭,42,湖北省,114531217 ,0 ,114531217 
600,巴拉圭,43,湖南省,106392670 ,3002 ,106395672 
600,巴拉圭,44,广东省,2090646852 ,36424186 ,2127071038 
600,巴拉圭,45,广西壮族自治区,52945885 ,4797834 ,57743719 
600,巴拉圭,46,海南省,40760367 ,3238306 ,43998673 
600,巴拉圭,50,重庆市,280793887 ,8013407 ,288807294 
600,巴拉圭,51,四川省,54113958 ,27970 ,54141928 
600,巴拉圭,52,贵州省,4033424 ,0 ,4033424 
600,巴拉圭,53,云南省,30881256 ,0 ,30881256 
600,巴拉圭,61,陕西省,45736223 ,452395 ,46188618 
600,巴拉圭,62,甘肃省,11483 ,0 ,11483 
600,巴拉圭,64,宁夏回族自治区,46377207 ,0 ,46377207 
600,巴拉圭,65,新疆维吾尔自治区,5654255 ,0 ,5654255 
604,秘鲁,11,北京市,2805537482 ,13122334992 ,15927872474 
604,秘鲁,12,天津市,1400630250 ,279381568 ,1680011818 
604,秘鲁,13,河北省,1776405351 ,423821943 ,2200227294 
604,秘鲁,14,山西省,283139689 ,1339647974 ,1622787663 
604,秘鲁,15,内蒙古自治区,401928773 ,517579253 ,919508026 
604,秘鲁,21,辽宁省,1805700991 ,1238996432 ,3044697423 
604,秘鲁,22,吉林省,90590989 ,798750947 ,889341936 
604,秘鲁,23,黑龙江省,172136650 ,1421467706 ,1593604356 
604,秘鲁,31,上海市,2562424867 ,6408072823 ,8970497690 
604,秘鲁,32,江苏省,8593960805 ,3119950122 ,11713910927 
604,秘鲁,33,浙江省,14612250365 ,13195660300 ,27807910665 
604,秘鲁,34,安徽省,2463725012 ,13276000326 ,15739725338 
604,秘鲁,35,福建省,3385280665 ,20169625721 ,23554906386 
604,秘鲁,36,江西省,1602330062 ,1720762724 ,3323092786 
604,秘鲁,37,山东省,5854111700 ,12122132281 ,17976243981 
604,秘鲁,41,河南省,1034847497 ,5615290766 ,6650138263 
604,秘鲁,42,湖北省,1646458634 ,3137576626 ,4784035260 
604,秘鲁,43,湖南省,1376748423 ,2982504865 ,4359253288 
604,秘鲁,44,广东省,10272029400 ,4327188991 ,14599218391 
604,秘鲁,45,广西壮族自治区,543518103 ,9157968778 ,9701486881 
604,秘鲁,46,海南省,108748244 ,201237381 ,309985625 
604,秘鲁,50,重庆市,3027301169 ,284658134 ,3311959303 
604,秘鲁,51,四川省,668991495 ,1289294592 ,1958286087 
604,秘鲁,52,贵州省,202495234 ,23645929 ,226141163 
604,秘鲁,53,云南省,454139834 ,7022012784 ,7476152618 
604,秘鲁,54,西藏自治区,8312660 ,76823900 ,85136560 
604,秘鲁,61,陕西省,208219194 ,569602896 ,777822090 
604,秘鲁,62,甘肃省,42699726 ,282568490 ,325268216 
604,秘鲁,63,青海省,2627912 ,0 ,2627912 
604,秘鲁,64,宁夏回族自治区,71773760 ,47168 ,71820928 
604,秘鲁,65,新疆维吾尔自治区,54914167 ,0 ,54914167 
608,菲律宾,11,北京市,11404470498 ,3850971670 ,15255442168 
608,菲律宾,12,天津市,3244696030 ,2852199816 ,6096895846 
608,菲律宾,13,河北省,5844988925 ,366223408 ,6211212333 
608,菲律宾,14,山西省,137683392 ,1091120241 ,1228803633 
608,菲律宾,15,内蒙古自治区,797432791 ,470050287 ,1267483078 
608,菲律宾,21,辽宁省,3231915682 ,786377406 ,4018293088 
608,菲律宾,22,吉林省,666269115 ,439616476 ,1105885591 
608,菲律宾,23,黑龙江省,737942210 ,4824117 ,742766327 
608,菲律宾,31,上海市,10036903913 ,15825202878 ,25862106791 
608,菲律宾,32,江苏省,26896729310 ,18375490097 ,45272219407 
608,菲律宾,33,浙江省,44657349479 ,6398951113 ,51056300592 
608,菲律宾,34,安徽省,4933701590 ,1471467074 ,6405168664 
608,菲律宾,35,福建省,55662952702 ,7087188678 ,62750141380 
608,菲律宾,36,江西省,14362658529 ,385815813 ,14748474342 
608,菲律宾,37,山东省,31333583314 ,4542587639 ,35876170953 
608,菲律宾,41,河南省,1849680401 ,1179459603 ,3029140004 
608,菲律宾,42,湖北省,8974737028 ,543689863 ,9518426891 
608,菲律宾,43,湖南省,11753685471 ,1078387837 ,12832073308 
608,菲律宾,44,广东省,53786330387 ,43565404628 ,97351735015 
608,菲律宾,45,广西壮族自治区,3452944771 ,1556000957 ,5008945728 
608,菲律宾,46,海南省,1882344683 ,55441960 ,1937786643 
608,菲律宾,50,重庆市,5954301084 ,1251952479 ,7206253563 
608,菲律宾,51,四川省,4787803761 ,1643295690 ,6431099451 
608,菲律宾,52,贵州省,753278824 ,26343488 ,779622312 
608,菲律宾,53,云南省,3156424387 ,27810484 ,3184234871 
608,菲律宾,54,西藏自治区,1409518 ,274328 ,1683846 
608,菲律宾,61,陕西省,1099693418 ,1144065863 ,2243759281 
608,菲律宾,62,甘肃省,53007081 ,146732370 ,199739451 
608,菲律宾,63,青海省,7111020 ,44986009 ,52097029 
608,菲律宾,64,宁夏回族自治区,166245391 ,1822426 ,168067817 
608,菲律宾,65,新疆维吾尔自治区,496670374 ,16021251 ,512691625 
616,波兰,11,北京市,2596098788 ,2852067691 ,5448166479 
616,波兰,12,天津市,4028087974 ,658064881 ,4686152855 
616,波兰,13,河北省,1996517835 ,247169440 ,2243687275 
616,波兰,14,山西省,201539091 ,9086315 ,210625406 
616,波兰,15,内蒙古自治区,160496664 ,2790776 ,163287440 
616,波兰,21,辽宁省,2161080685 ,2507715942 ,4668796627 
616,波兰,22,吉林省,217422574 ,1705549560 ,1922972134 
616,波兰,23,黑龙江省,471124385 ,75347027 ,546471412 
616,波兰,31,上海市,8804836039 ,5038953355 ,13843789394 
616,波兰,32,江苏省,32399781744 ,3173123433 ,35572905177 
616,波兰,33,浙江省,35251063037 ,3042889352 ,38293952389 
616,波兰,34,安徽省,3911610086 ,291030453 ,4202640539 
616,波兰,35,福建省,11580915039 ,668740971 ,12249656010 
616,波兰,36,江西省,5470205084 ,78990708 ,5549195792 
616,波兰,37,山东省,12367490648 ,837344758 ,13204835406 
616,波兰,41,河南省,3142322873 ,68318869 ,3210641742 
616,波兰,42,湖北省,5106765178 ,275284107 ,5382049285 
616,波兰,43,湖南省,3712065310 ,72630902 ,3784696212 
616,波兰,44,广东省,41919834522 ,2215431930 ,44135266452 
616,波兰,45,广西壮族自治区,570191871 ,23162332 ,593354203 
616,波兰,46,海南省,114693127 ,51661897 ,166355024 
616,波兰,50,重庆市,6357652492 ,129245720 ,6486898212 
616,波兰,51,四川省,6114269902 ,379679084 ,6493948986 
616,波兰,52,贵州省,210269837 ,1487727 ,211757564 
616,波兰,53,云南省,486357986 ,25766541 ,512124527 
616,波兰,54,西藏自治区,45939423 ,18092 ,45957515 
616,波兰,61,陕西省,2997217705 ,723817702 ,3721035407 
616,波兰,62,甘肃省,19456702 ,172477 ,19629179 
616,波兰,63,青海省,6477612 ,4194947 ,10672559 
616,波兰,64,宁夏回族自治区,221022029 ,460530 ,221482559 
616,波兰,65,新疆维吾尔自治区,297136897 ,25806484 ,322943381 
620,葡萄牙,11,北京市,839960179 ,541748334 ,1381708513 
620,葡萄牙,12,天津市,597369098 ,187684531 ,785053629 
620,葡萄牙,13,河北省,929803968 ,262877118 ,1192681086 
620,葡萄牙,14,山西省,10490382 ,57898624 ,68389006 
620,葡萄牙,15,内蒙古自治区,66550227 ,10421195 ,76971422 
620,葡萄牙,21,辽宁省,333077440 ,2363393902 ,2696471342 
620,葡萄牙,22,吉林省,56485160 ,4396736124 ,4453221284 
620,葡萄牙,23,黑龙江省,78245289 ,24047520 ,102292809 
620,葡萄牙,31,上海市,2213663001 ,2927685580 ,5141348581 
620,葡萄牙,32,江苏省,5821568041 ,690971464 ,6512539505 
620,葡萄牙,33,浙江省,8065603454 ,959882385 ,9025485839 
620,葡萄牙,34,安徽省,1075120372 ,58873356 ,1133993728 
620,葡萄牙,35,福建省,902115734 ,541243126 ,1443358860 
620,葡萄牙,36,江西省,983291642 ,9326819 ,992618461 
620,葡萄牙,37,山东省,1621251388 ,201675176 ,1822926564 
620,葡萄牙,41,河南省,328656868 ,50202152 ,378859020 
620,葡萄牙,42,湖北省,280305551 ,95688149 ,375993700 
620,葡萄牙,43,湖南省,261822277 ,57553520 ,319375797 
620,葡萄牙,44,广东省,4864885432 ,1623747281 ,6488632713 
620,葡萄牙,45,广西壮族自治区,102639555 ,15331070 ,117970625 
620,葡萄牙,46,海南省,8102195 ,156175604 ,164277799 
620,葡萄牙,50,重庆市,445046142 ,40949205 ,485995347 
620,葡萄牙,51,四川省,211409746 ,203730589 ,415140335 
620,葡萄牙,52,贵州省,9983300 ,4085665 ,14068965 
620,葡萄牙,53,云南省,64051062 ,8080533 ,72131595 
620,葡萄牙,54,西藏自治区,7845310 ,0 ,7845310 
620,葡萄牙,61,陕西省,180269571 ,4897011 ,185166582 
620,葡萄牙,62,甘肃省,1731526 ,0 ,1731526 
620,葡萄牙,63,青海省,27285 ,0 ,27285 
620,葡萄牙,64,宁夏回族自治区,4569514 ,403679 ,4973193 
620,葡萄牙,65,新疆维吾尔自治区,48692512 ,3487 ,48695999 
624,几内亚比绍,11,北京市,83696015 ,1818 ,83697833 
624,几内亚比绍,12,天津市,8887705 ,0 ,8887705 
624,几内亚比绍,13,河北省,6545980 ,0 ,6545980 
624,几内亚比绍,21,辽宁省,15375 ,0 ,15375 
624,几内亚比绍,23,黑龙江省,2534675 ,0 ,2534675 
624,几内亚比绍,31,上海市,2296237 ,365 ,2296602 
624,几内亚比绍,32,江苏省,11918836 ,125 ,11918961 
624,几内亚比绍,33,浙江省,44806710 ,0 ,44806710 
624,几内亚比绍,35,福建省,3659725 ,0 ,3659725 
624,几内亚比绍,36,江西省,7170249 ,0 ,7170249 
624,几内亚比绍,37,山东省,10946066 ,0 ,10946066 
624,几内亚比绍,41,河南省,12282285 ,0 ,12282285 
624,几内亚比绍,42,湖北省,1607957 ,0 ,1607957 
624,几内亚比绍,43,湖南省,5252020 ,0 ,5252020 
624,几内亚比绍,44,广东省,45282340 ,13970 ,45296310 
624,几内亚比绍,45,广西壮族自治区,2678373 ,0 ,2678373 
624,几内亚比绍,50,重庆市,16287671 ,0 ,16287671 
624,几内亚比绍,51,四川省,1956995 ,0 ,1956995 
624,几内亚比绍,53,云南省,2362704 ,0 ,2362704 
626,东帝汶,11,北京市,108384244 ,443412395 ,551796639 
626,东帝汶,12,天津市,1647727 ,310230 ,1957957 
626,东帝汶,13,河北省,38820357 ,0 ,38820357 
626,东帝汶,14,山西省,4053081 ,0 ,4053081 
626,东帝汶,21,辽宁省,7175898 ,13656 ,7189554 
626,东帝汶,23,黑龙江省,3857862 ,0 ,3857862 
626,东帝汶,31,上海市,156370552 ,14279 ,156384831 
626,东帝汶,32,江苏省,48784637 ,1750352 ,50534989 
626,东帝汶,33,浙江省,407661994 ,1624568 ,409286562 
626,东帝汶,34,安徽省,43731695 ,0 ,43731695 
626,东帝汶,35,福建省,55310044 ,162048821 ,217358865 
626,东帝汶,36,江西省,74785924 ,0 ,74785924 
626,东帝汶,37,山东省,209073060 ,0 ,209073060 
626,东帝汶,41,河南省,3488446 ,0 ,3488446 
626,东帝汶,42,湖北省,34317678 ,0 ,34317678 
626,东帝汶,43,湖南省,65191007 ,0 ,65191007 
626,东帝汶,44,广东省,149849743 ,253947 ,150103690 
626,东帝汶,45,广西壮族自治区,10750220 ,0 ,10750220 
626,东帝汶,50,重庆市,15521804 ,0 ,15521804 
626,东帝汶,51,四川省,15386238 ,0 ,15386238 
626,东帝汶,53,云南省,10443937 ,0 ,10443937 
626,东帝汶,61,陕西省,2255143 ,0 ,2255143 
630,波多黎各,11,北京市,149219438 ,45851423 ,195070861 
630,波多黎各,12,天津市,32613268 ,101715 ,32714983 
630,波多黎各,13,河北省,51033708 ,0 ,51033708 
630,波多黎各,14,山西省,533915 ,0 ,533915 
630,波多黎各,15,内蒙古自治区,215196 ,11419 ,226615 
630,波多黎各,21,辽宁省,214205659 ,756181095 ,970386754 
630,波多黎各,22,吉林省,109322 ,101828 ,211150 
630,波多黎各,23,黑龙江省,1827917 ,5755 ,1833672 
630,波多黎各,31,上海市,244620895 ,2302616395 ,2547237290 
630,波多黎各,32,江苏省,650539022 ,1931054929 ,2581593951 
630,波多黎各,33,浙江省,1000907801 ,636801006 ,1637708807 
630,波多黎各,34,安徽省,129393604 ,6541396 ,135935000 
630,波多黎各,35,福建省,287539264 ,33039406 ,320578670 
630,波多黎各,36,江西省,66663790 ,0 ,66663790 
630,波多黎各,37,山东省,401634358 ,2991461 ,404625819 
630,波多黎各,41,河南省,42355907 ,545848 ,42901755 
630,波多黎各,42,湖北省,39526889 ,1205874 ,40732763 
630,波多黎各,43,湖南省,50927600 ,1578 ,50929178 
630,波多黎各,44,广东省,1439554581 ,672102730 ,2111657311 
630,波多黎各,45,广西壮族自治区,9524962 ,2434772 ,11959734 
630,波多黎各,46,海南省,3249815 ,753775 ,4003590 
630,波多黎各,50,重庆市,35730211 ,4009 ,35734220 
630,波多黎各,51,四川省,46822101 ,2896013 ,49718114 
630,波多黎各,52,贵州省,1054479 ,343754 ,1398233 
630,波多黎各,53,云南省,16649796 ,0 ,16649796 
630,波多黎各,61,陕西省,4140135 ,75833836 ,79973971 
630,波多黎各,62,甘肃省,714336 ,13991923 ,14706259 
630,波多黎各,65,新疆维吾尔自治区,333442 ,0 ,333442 
634,卡塔尔,11,北京市,466992386 ,35738153535 ,36205145921 
634,卡塔尔,12,天津市,251839002 ,416359188 ,668198190 
634,卡塔尔,13,河北省,580027519 ,7974866366 ,8554893885 
634,卡塔尔,14,山西省,38067949 ,0 ,38067949 
634,卡塔尔,15,内蒙古自治区,20873587 ,44415 ,20918002 
634,卡塔尔,21,辽宁省,190721778 ,6119120517 ,6309842295 
634,卡塔尔,22,吉林省,85031166 ,3294630 ,88325796 
634,卡塔尔,23,黑龙江省,42902787 ,0 ,42902787 
634,卡塔尔,31,上海市,867719975 ,1589318512 ,2457038487 
634,卡塔尔,32,江苏省,2088317532 ,19386975130 ,21475292662 
634,卡塔尔,33,浙江省,3117153810 ,10128134349 ,13245288159 
634,卡塔尔,34,安徽省,609485605 ,302335978 ,911821583 
634,卡塔尔,35,福建省,788139378 ,7870541798 ,8658681176 
634,卡塔尔,36,江西省,642190708 ,2409878 ,644600586 
634,卡塔尔,37,山东省,2304849560 ,4060320441 ,6365170001 
634,卡塔尔,41,河南省,745958868 ,898091 ,746856959 
634,卡塔尔,42,湖北省,516212646 ,14345870 ,530558516 
634,卡塔尔,43,湖南省,677723001 ,8711162 ,686434163 
634,卡塔尔,44,广东省,4656843555 ,5782918478 ,10439762033 
634,卡塔尔,45,广西壮族自治区,202202491 ,3235667122 ,3437869613 
634,卡塔尔,46,海南省,19585384 ,199634826 ,219220210 
634,卡塔尔,50,重庆市,247435894 ,1129449 ,248565343 
634,卡塔尔,51,四川省,188102101 ,9916254 ,198018355 
634,卡塔尔,52,贵州省,25348686 ,339004720 ,364353406 
634,卡塔尔,53,云南省,206283973 ,4479490948 ,4685774921 
634,卡塔尔,61,陕西省,64208578 ,84803601 ,149012179 
634,卡塔尔,62,甘肃省,3565961 ,0 ,3565961 
634,卡塔尔,63,青海省,7963708 ,0 ,7963708 
634,卡塔尔,64,宁夏回族自治区,22412826 ,0 ,22412826 
634,卡塔尔,65,新疆维吾尔自治区,32752624 ,0 ,32752624 
638,留尼汪,11,北京市,1768574 ,612574 ,2381148 
638,留尼汪,12,天津市,14052869 ,0 ,14052869 
638,留尼汪,13,河北省,21460612 ,0 ,21460612 
638,留尼汪,14,山西省,377593 ,0 ,377593 
638,留尼汪,15,内蒙古自治区,7979 ,0 ,7979 
638,留尼汪,21,辽宁省,10225820 ,0 ,10225820 
638,留尼汪,22,吉林省,465783 ,0 ,465783 
638,留尼汪,23,黑龙江省,6034822 ,0 ,6034822 
638,留尼汪,31,上海市,34676069 ,7463 ,34683532 
638,留尼汪,32,江苏省,89937346 ,0 ,89937346 
638,留尼汪,33,浙江省,226060741 ,0 ,226060741 
638,留尼汪,34,安徽省,23843314 ,0 ,23843314 
638,留尼汪,35,福建省,52394699 ,1186 ,52395885 
638,留尼汪,36,江西省,31179012 ,0 ,31179012 
638,留尼汪,37,山东省,224963950 ,124 ,224964074 
638,留尼汪,41,河南省,13133222 ,0 ,13133222 
638,留尼汪,42,湖北省,37459836 ,0 ,37459836 
638,留尼汪,43,湖南省,71407035 ,0 ,71407035 
638,留尼汪,44,广东省,312844753 ,13755 ,312858508 
638,留尼汪,45,广西壮族自治区,2549961 ,0 ,2549961 
638,留尼汪,46,海南省,1426960 ,0 ,1426960 
638,留尼汪,50,重庆市,33174166 ,0 ,33174166 
638,留尼汪,51,四川省,20674458 ,0 ,20674458 
638,留尼汪,52,贵州省,1546005 ,0 ,1546005 
638,留尼汪,53,云南省,7422337 ,0 ,7422337 
638,留尼汪,61,陕西省,1423906 ,0 ,1423906 
638,留尼汪,62,甘肃省,88 ,0 ,88 
638,留尼汪,64,宁夏回族自治区,517574 ,0 ,517574 
642,罗马尼亚,11,北京市,306283768 ,1871465907 ,2177749675 
642,罗马尼亚,12,天津市,696916517 ,267702494 ,964619011 
642,罗马尼亚,13,河北省,465592513 ,73051352 ,538643865 
642,罗马尼亚,14,山西省,220472780 ,9631454 ,230104234 
642,罗马尼亚,15,内蒙古自治区,11998752 ,3398138 ,15396890 
642,罗马尼亚,21,辽宁省,257813070 ,2614549482 ,2872362552 
642,罗马尼亚,22,吉林省,39441055 ,1414323677 ,1453764732 
642,罗马尼亚,23,黑龙江省,22006592 ,17410726 ,39417318 
642,罗马尼亚,31,上海市,1686547333 ,4199311772 ,5885859105 
642,罗马尼亚,32,江苏省,8588634009 ,1105138744 ,9693772753 
642,罗马尼亚,33,浙江省,7864640094 ,760550204 ,8625190298 
642,罗马尼亚,34,安徽省,688298301 ,65493647 ,753791948 
642,罗马尼亚,35,福建省,1214893146 ,771537660 ,1986430806 
642,罗马尼亚,36,江西省,487371883 ,24212343 ,511584226 
642,罗马尼亚,37,山东省,2524016576 ,648335157 ,3172351733 
642,罗马尼亚,41,河南省,318763469 ,9785258 ,328548727 
642,罗马尼亚,42,湖北省,964992409 ,106013396 ,1071005805 
642,罗马尼亚,43,湖南省,555471081 ,89446962 ,644918043 
642,罗马尼亚,44,广东省,6752821153 ,872534384 ,7625355537 
642,罗马尼亚,45,广西壮族自治区,195614255 ,7308340 ,202922595 
642,罗马尼亚,46,海南省,35448988 ,183933454 ,219382442 
642,罗马尼亚,50,重庆市,834912548 ,137084509 ,971997057 
642,罗马尼亚,51,四川省,1149980624 ,102233527 ,1252214151 
642,罗马尼亚,52,贵州省,57844614 ,441802 ,58286416 
642,罗马尼亚,53,云南省,120076906 ,167415575 ,287492481 
642,罗马尼亚,54,西藏自治区,322955 ,0 ,322955 
642,罗马尼亚,61,陕西省,79123891 ,29457171 ,108581062 
642,罗马尼亚,62,甘肃省,5560444 ,17603 ,5578047 
642,罗马尼亚,63,青海省,3286639 ,0 ,3286639 
642,罗马尼亚,64,宁夏回族自治区,5307255 ,1959 ,5309214 
642,罗马尼亚,65,新疆维吾尔自治区,35070544 ,788243 ,35858787 
643,俄罗斯联邦,11,北京市,13739978217 ,132619170556 ,146359148773 
643,俄罗斯联邦,12,天津市,6459187143 ,2230505796 ,8689692939 
643,俄罗斯联邦,13,河北省,10146183820 ,9694179755 ,19840363575 
643,俄罗斯联邦,14,山西省,1931609382 ,384935624 ,2316545006 
643,俄罗斯联邦,15,内蒙古自治区,3128845775 ,11002353903 ,14131199678 
643,俄罗斯联邦,21,辽宁省,7684868747 ,15670695999 ,23355564746 
643,俄罗斯联邦,22,吉林省,3995987420 ,7536213635 ,11532201055 
643,俄罗斯联邦,23,黑龙江省,11053617420 ,122613164273 ,133666781693 
643,俄罗斯联邦,31,上海市,15140141921 ,25703780774 ,40843922695 
643,俄罗斯联邦,32,江苏省,36385216714 ,19487319636 ,55872536350 
643,俄罗斯联邦,33,浙江省,66164774159 ,24572284956 ,90737059115 
643,俄罗斯联邦,34,安徽省,7181102050 ,1520555122 ,8701657172 
643,俄罗斯联邦,35,福建省,11920539311 ,20712150388 ,32632689699 
643,俄罗斯联邦,36,江西省,4430660656 ,1185073796 ,5615734452 
643,俄罗斯联邦,37,山东省,39531958759 ,103010380233 ,142542338992 
643,俄罗斯联邦,41,河南省,7773274701 ,8355621037 ,16128895738 
643,俄罗斯联邦,42,湖北省,4983267749 ,2670825089 ,7654092838 
643,俄罗斯联邦,43,湖南省,6971874703 ,968026336 ,7939901039 
643,俄罗斯联邦,44,广东省,56225973724 ,16363081853 ,72589055577 
643,俄罗斯联邦,45,广西壮族自治区,1833295599 ,2208287689 ,4041583288 
643,俄罗斯联邦,46,海南省,816977553 ,4441522519 ,5258500072 
643,俄罗斯联邦,50,重庆市,4812506154 ,5321637583 ,10134143737 
643,俄罗斯联邦,51,四川省,8270425292 ,3570005322 ,11840430614 
643,俄罗斯联邦,52,贵州省,748097570 ,43401506 ,791499076 
643,俄罗斯联邦,53,云南省,352177458 ,390331736 ,742509194 
643,俄罗斯联邦,54,西藏自治区,50926758 ,13654 ,50940412 
643,俄罗斯联邦,61,陕西省,4527810959 ,5052971517 ,9580782476 
643,俄罗斯联邦,62,甘肃省,268189146 ,1743718398 ,2011907544 
643,俄罗斯联邦,63,青海省,28761652 ,2586600 ,31348252 
643,俄罗斯联邦,64,宁夏回族自治区,429785977 ,81488046 ,511274023 
643,俄罗斯联邦,65,新疆维吾尔自治区,6376435938 ,1016391705 ,7392827643 
646,卢旺达,11,北京市,359153034 ,917963 ,360070997 
646,卢旺达,12,天津市,22428748 ,1778 ,22430526 
646,卢旺达,13,河北省,27445858 ,0 ,27445858 
646,卢旺达,14,山西省,1268617 ,0 ,1268617 
646,卢旺达,21,辽宁省,1654343 ,8 ,1654351 
646,卢旺达,22,吉林省,21751961 ,0 ,21751961 
646,卢旺达,23,黑龙江省,1559714 ,0 ,1559714 
646,卢旺达,31,上海市,54422274 ,13892709 ,68314983 
646,卢旺达,32,江苏省,136097459 ,9814600 ,145912059 
646,卢旺达,33,浙江省,270655219 ,6766700 ,277421919 
646,卢旺达,34,安徽省,18562240 ,64 ,18562304 
646,卢旺达,35,福建省,305673865 ,32148793 ,337822658 
646,卢旺达,36,江西省,20097761 ,80359001 ,100456762 
646,卢旺达,37,山东省,229758032 ,919007 ,230677039 
646,卢旺达,41,河南省,15596587 ,268239 ,15864826 
646,卢旺达,42,湖北省,18665178 ,0 ,18665178 
646,卢旺达,43,湖南省,19524460 ,7937391 ,27461851 
646,卢旺达,44,广东省,361031610 ,150324855 ,511356465 
646,卢旺达,45,广西壮族自治区,8879380 ,0 ,8879380 
646,卢旺达,46,海南省,1931284 ,0 ,1931284 
646,卢旺达,50,重庆市,51528656 ,636 ,51529292 
646,卢旺达,51,四川省,23142610 ,3102840 ,26245450 
646,卢旺达,52,贵州省,1260062 ,0 ,1260062 
646,卢旺达,53,云南省,2100680 ,0 ,2100680 
646,卢旺达,61,陕西省,38511178 ,641010 ,39152188 
646,卢旺达,64,宁夏回族自治区,550913 ,28717623 ,29268536 
646,卢旺达,65,新疆维吾尔自治区,1015611 ,359044 ,1374655 
662,圣卢西亚,11,北京市,1042086 ,204 ,1042290 
662,圣卢西亚,12,天津市,363392 ,0 ,363392 
662,圣卢西亚,13,河北省,1310945 ,0 ,1310945 
662,圣卢西亚,14,山西省,551965 ,0 ,551965 
662,圣卢西亚,21,辽宁省,272606 ,0 ,272606 
662,圣卢西亚,31,上海市,11210804 ,135081 ,11345885 
662,圣卢西亚,32,江苏省,7448128 ,70 ,7448198 
662,圣卢西亚,33,浙江省,49826995 ,0 ,49826995 
662,圣卢西亚,34,安徽省,5751223 ,0 ,5751223 
662,圣卢西亚,35,福建省,13262604 ,0 ,13262604 
662,圣卢西亚,36,江西省,3729998 ,0 ,3729998 
662,圣卢西亚,37,山东省,35243237 ,0 ,35243237 
662,圣卢西亚,41,河南省,2360454 ,594 ,2361048 
662,圣卢西亚,42,湖北省,1255708 ,0 ,1255708 
662,圣卢西亚,43,湖南省,3438493 ,0 ,3438493 
662,圣卢西亚,44,广东省,25299176 ,137124 ,25436300 
662,圣卢西亚,45,广西壮族自治区,2365005 ,0 ,2365005 
662,圣卢西亚,46,海南省,1222453 ,0 ,1222453 
662,圣卢西亚,50,重庆市,524563 ,0 ,524563 
662,圣卢西亚,51,四川省,8758 ,0 ,8758 
662,圣卢西亚,52,贵州省,39 ,0 ,39 
662,圣卢西亚,53,云南省,949598 ,0 ,949598 
662,圣卢西亚,61,陕西省,541612 ,0 ,541612 
666,圣皮埃尔和密克隆,13,河北省,39 ,0 ,39 
666,圣皮埃尔和密克隆,31,上海市,1870 ,0 ,1870 
666,圣皮埃尔和密克隆,33,浙江省,859 ,0 ,859 
666,圣皮埃尔和密克隆,34,安徽省,21196 ,0 ,21196 
666,圣皮埃尔和密克隆,35,福建省,39 ,0 ,39 
666,圣皮埃尔和密克隆,36,江西省,39 ,0 ,39 
666,圣皮埃尔和密克隆,37,山东省,39 ,0 ,39 
666,圣皮埃尔和密克隆,41,河南省,1250 ,0 ,1250 
666,圣皮埃尔和密克隆,42,湖北省,313 ,0 ,313 
666,圣皮埃尔和密克隆,43,湖南省,117 ,0 ,117 
666,圣皮埃尔和密克隆,44,广东省,2777 ,0 ,2777 
666,圣皮埃尔和密克隆,52,贵州省,39 ,0 ,39 
670,圣文森特和格林纳丁斯,11,北京市,10639 ,0 ,10639 
670,圣文森特和格林纳丁斯,12,天津市,42994 ,0 ,42994 
670,圣文森特和格林纳丁斯,13,河北省,850591 ,0 ,850591 
670,圣文森特和格林纳丁斯,21,辽宁省,2131065 ,0 ,2131065 
670,圣文森特和格林纳丁斯,23,黑龙江省,1384998 ,0 ,1384998 
670,圣文森特和格林纳丁斯,31,上海市,2812491 ,64 ,2812555 
670,圣文森特和格林纳丁斯,32,江苏省,9359562 ,0 ,9359562 
670,圣文森特和格林纳丁斯,33,浙江省,25544991 ,178 ,25545169 
670,圣文森特和格林纳丁斯,34,安徽省,2980883 ,0 ,2980883 
670,圣文森特和格林纳丁斯,35,福建省,2588786 ,17599 ,2606385 
670,圣文森特和格林纳丁斯,36,江西省,6705060 ,0 ,6705060 
670,圣文森特和格林纳丁斯,37,山东省,10660654 ,0 ,10660654 
670,圣文森特和格林纳丁斯,41,河南省,2494556 ,0 ,2494556 
670,圣文森特和格林纳丁斯,42,湖北省,196753 ,0 ,196753 
670,圣文森特和格林纳丁斯,43,湖南省,1102645 ,0 ,1102645 
670,圣文森特和格林纳丁斯,44,广东省,15760501 ,1991 ,15762492 
670,圣文森特和格林纳丁斯,45,广西壮族自治区,32204 ,0 ,32204 
670,圣文森特和格林纳丁斯,46,海南省,295823 ,0 ,295823 
670,圣文森特和格林纳丁斯,50,重庆市,564658 ,0 ,564658 
670,圣文森特和格林纳丁斯,51,四川省,313618 ,0 ,313618 
670,圣文森特和格林纳丁斯,52,贵州省,39 ,0 ,39 
670,圣文森特和格林纳丁斯,61,陕西省,382360 ,0 ,382360 
674,圣马力诺,11,北京市,217658 ,2123157 ,2340815 
674,圣马力诺,12,天津市,3020276 ,0 ,3020276 
674,圣马力诺,13,河北省,1052637 ,0 ,1052637 
674,圣马力诺,14,山西省,72495 ,0 ,72495 
674,圣马力诺,15,内蒙古自治区,39052 ,0 ,39052 
674,圣马力诺,23,黑龙江省,221717 ,0 ,221717 
674,圣马力诺,31,上海市,917669 ,7180877 ,8098546 
674,圣马力诺,32,江苏省,3267403 ,717553 ,3984956 
674,圣马力诺,33,浙江省,5133693 ,1751362 ,6885055 
674,圣马力诺,34,安徽省,3070663 ,0 ,3070663 
674,圣马力诺,35,福建省,1659071 ,12400 ,1671471 
674,圣马力诺,36,江西省,336420 ,0 ,336420 
674,圣马力诺,37,山东省,20892665 ,1911 ,20894576 
674,圣马力诺,41,河南省,613 ,0 ,613 
674,圣马力诺,42,湖北省,388908 ,0 ,388908 
674,圣马力诺,43,湖南省,328678 ,0 ,328678 
674,圣马力诺,44,广东省,7827491 ,13507698 ,21335189 
674,圣马力诺,45,广西壮族自治区,2609206 ,0 ,2609206 
674,圣马力诺,50,重庆市,638 ,12422 ,13060 
674,圣马力诺,51,四川省,18905 ,1397818 ,1416723 
674,圣马力诺,52,贵州省,274 ,0 ,274 
674,圣马力诺,61,陕西省,30197 ,14158 ,44355 
674,圣马力诺,65,新疆维吾尔自治区,78 ,0 ,78 
678,圣多美和普林西比,11,北京市,512353 ,0 ,512353 
678,圣多美和普林西比,12,天津市,564072 ,0 ,564072 
678,圣多美和普林西比,13,河北省,857226 ,0 ,857226 
678,圣多美和普林西比,21,辽宁省,370 ,0 ,370 
678,圣多美和普林西比,31,上海市,422020 ,116924 ,538944 
678,圣多美和普林西比,32,江苏省,3154911 ,854600 ,4009511 
678,圣多美和普林西比,33,浙江省,42944561 ,3248 ,42947809 
678,圣多美和普林西比,34,安徽省,2125192 ,0 ,2125192 
678,圣多美和普林西比,35,福建省,816064 ,0 ,816064 
678,圣多美和普林西比,36,江西省,1675012 ,0 ,1675012 
678,圣多美和普林西比,37,山东省,8162386 ,384 ,8162770 
678,圣多美和普林西比,41,河南省,2308264 ,0 ,2308264 
678,圣多美和普林西比,42,湖北省,2909054 ,0 ,2909054 
678,圣多美和普林西比,43,湖南省,3466231 ,0 ,3466231 
678,圣多美和普林西比,44,广东省,7600420 ,4601 ,7605021 
678,圣多美和普林西比,50,重庆市,542854 ,0 ,542854 
678,圣多美和普林西比,51,四川省,39 ,0 ,39 
678,圣多美和普林西比,53,云南省,1002099 ,0 ,1002099 
682,沙特阿拉伯,11,北京市,3811076962 ,163065099778 ,166876176740 
682,沙特阿拉伯,12,天津市,3047499554 ,509445454 ,3556945008 
682,沙特阿拉伯,13,河北省,4282521748 ,422264235 ,4704785983 
682,沙特阿拉伯,14,山西省,962747890 ,182311188 ,1145059078 
682,沙特阿拉伯,15,内蒙古自治区,1194588180 ,14453740 ,1209041920 
682,沙特阿拉伯,21,辽宁省,1920021404 ,42171931416 ,44091952820 
682,沙特阿拉伯,22,吉林省,491302426 ,17772588 ,509075014 
682,沙特阿拉伯,23,黑龙江省,230074393 ,439377566 ,669451959 
682,沙特阿拉伯,31,上海市,7191650370 ,7201264492 ,14392914862 
682,沙特阿拉伯,32,江苏省,16829711319 ,13120168863 ,29949880182 
682,沙特阿拉伯,33,浙江省,31373270755 ,63581929297 ,94955200052 
682,沙特阿拉伯,34,安徽省,4247631658 ,963610558 ,5211242216 
682,沙特阿拉伯,35,福建省,8987051231 ,41396923171 ,50383974402 
682,沙特阿拉伯,36,江西省,4365527823 ,331218477 ,4696746300 
682,沙特阿拉伯,37,山东省,20373341537 ,5006111266 ,25379452803 
682,沙特阿拉伯,41,河南省,5937247447 ,170062733 ,6107310180 
682,沙特阿拉伯,42,湖北省,2532574114 ,290905982 ,2823480096 
682,沙特阿拉伯,43,湖南省,6145605428 ,168334334 ,6313939762 
682,沙特阿拉伯,44,广东省,41747165497 ,15881090173 ,57628255670 
682,沙特阿拉伯,45,广西壮族自治区,1763810667 ,12124988698 ,13888799365 
682,沙特阿拉伯,46,海南省,176935151 ,2373096857 ,2550032008 
682,沙特阿拉伯,50,重庆市,5424954325 ,219346224 ,5644300549 
682,沙特阿拉伯,51,四川省,2360819920 ,1280225861 ,3641045781 
682,沙特阿拉伯,52,贵州省,387354093 ,167313202 ,554667295 
682,沙特阿拉伯,53,云南省,1513893205 ,19690349552 ,21204242757 
682,沙特阿拉伯,54,西藏自治区,8 ,0 ,8 
682,沙特阿拉伯,61,陕西省,976352315 ,54615469 ,1030967784 
682,沙特阿拉伯,62,甘肃省,63432379 ,504135 ,63936514 
682,沙特阿拉伯,63,青海省,13390265 ,0 ,13390265 
682,沙特阿拉伯,64,宁夏回族自治区,53216180 ,0 ,53216180 
682,沙特阿拉伯,65,新疆维吾尔自治区,292092539 ,1703271 ,293795810 
686,塞内加尔,11,北京市,304847014 ,289243249 ,594090263 
686,塞内加尔,12,天津市,125436144 ,125604080 ,251040224 
686,塞内加尔,13,河北省,463803976 ,195444562 ,659248538 
686,塞内加尔,14,山西省,7467826 ,0 ,7467826 
686,塞内加尔,15,内蒙古自治区,71053385 ,0 ,71053385 
686,塞内加尔,21,辽宁省,27416681 ,107712833 ,135129514 
686,塞内加尔,22,吉林省,21627902 ,13832 ,21641734 
686,塞内加尔,23,黑龙江省,24463481 ,0 ,24463481 
686,塞内加尔,31,上海市,345542032 ,37717369 ,383259401 
686,塞内加尔,32,江苏省,1019595417 ,57649588 ,1077245005 
686,塞内加尔,33,浙江省,6232189059 ,53586002 ,6285775061 
686,塞内加尔,34,安徽省,446103286 ,44559004 ,490662290 
686,塞内加尔,35,福建省,850824887 ,63800494 ,914625381 
686,塞内加尔,36,江西省,656821127 ,1782546 ,658603673 
686,塞内加尔,37,山东省,3037773061 ,340768473 ,3378541534 
686,塞内加尔,41,河南省,97706363 ,115658521 ,213364884 
686,塞内加尔,42,湖北省,395229054 ,1683574 ,396912628 
686,塞内加尔,43,湖南省,728499121 ,0 ,728499121 
686,塞内加尔,44,广东省,3728162184 ,122906043 ,3851068227 
686,塞内加尔,45,广西壮族自治区,100485648 ,1027521 ,101513169 
686,塞内加尔,46,海南省,6375271 ,0 ,6375271 
686,塞内加尔,50,重庆市,379668948 ,3077 ,379672025 
686,塞内加尔,51,四川省,507114909 ,1365790 ,508480699 
686,塞内加尔,52,贵州省,31656331 ,0 ,31656331 
686,塞内加尔,53,云南省,185113339 ,727 ,185114066 
686,塞内加尔,54,西藏自治区,4684649 ,0 ,4684649 
686,塞内加尔,61,陕西省,77162628 ,16658 ,77179286 
686,塞内加尔,62,甘肃省,6550869 ,0 ,6550869 
686,塞内加尔,63,青海省,4458015 ,0 ,4458015 
686,塞内加尔,64,宁夏回族自治区,838483 ,0 ,838483 
686,塞内加尔,65,新疆维吾尔自治区,64469670 ,0 ,64469670 
688,塞尔维亚,11,北京市,1195932123 ,1374286022 ,2570218145 
688,塞尔维亚,12,天津市,450038507 ,84085253 ,534123760 
688,塞尔维亚,13,河北省,173670544 ,484293 ,174154837 
688,塞尔维亚,14,山西省,5397197 ,171287980 ,176685177 
688,塞尔维亚,15,内蒙古自治区,1830024 ,114797673 ,116627697 
688,塞尔维亚,21,辽宁省,66944647 ,274222294 ,341166941 
688,塞尔维亚,22,吉林省,52301933 ,429652830 ,481954763 
688,塞尔维亚,23,黑龙江省,3540000 ,13823148 ,17363148 
688,塞尔维亚,31,上海市,563457912 ,249584539 ,813042451 
688,塞尔维亚,32,江苏省,1748163920 ,188480883 ,1936644803 
688,塞尔维亚,33,浙江省,2192988563 ,357662627 ,2550651190 
688,塞尔维亚,34,安徽省,213059771 ,232002162 ,445061933 
688,塞尔维亚,35,福建省,1051400147 ,1639858908 ,2691259055 
688,塞尔维亚,36,江西省,136200285 ,27314 ,136227599 
688,塞尔维亚,37,山东省,921167819 ,443484913 ,1364652732 
688,塞尔维亚,41,河南省,141739710 ,261898430 ,403638140 
688,塞尔维亚,42,湖北省,94356647 ,1366302 ,95722949 
688,塞尔维亚,43,湖南省,214123469 ,262731242 ,476854711 
688,塞尔维亚,44,广东省,1570352190 ,159823301 ,1730175491 
688,塞尔维亚,45,广西壮族自治区,37352275 ,819276482 ,856628757 
688,塞尔维亚,46,海南省,229115379 ,25675666 ,254791045 
688,塞尔维亚,50,重庆市,61754528 ,1407354 ,63161882 
688,塞尔维亚,51,四川省,94902449 ,5174761 ,100077210 
688,塞尔维亚,52,贵州省,3014406 ,0 ,3014406 
688,塞尔维亚,53,云南省,8054258 ,6210958 ,14265216 
688,塞尔维亚,61,陕西省,24028497 ,14975 ,24043472 
688,塞尔维亚,62,甘肃省,964619 ,262527391 ,263492010 
688,塞尔维亚,63,青海省,382 ,0 ,382 
688,塞尔维亚,64,宁夏回族自治区,8925635 ,0 ,8925635 
688,塞尔维亚,65,新疆维吾尔自治区,1804878 ,0 ,1804878 
690,塞舌尔,11,北京市,1836738 ,48341 ,1885079 
690,塞舌尔,12,天津市,140043367 ,0 ,140043367 
690,塞舌尔,13,河北省,6601551 ,0 ,6601551 
690,塞舌尔,14,山西省,28778 ,0 ,28778 
690,塞舌尔,15,内蒙古自治区,31305 ,0 ,31305 
690,塞舌尔,21,辽宁省,4141899 ,313534 ,4455433 
690,塞舌尔,23,黑龙江省,32665 ,0 ,32665 
690,塞舌尔,31,上海市,13414746 ,56916 ,13471662 
690,塞舌尔,32,江苏省,30150242 ,370 ,30150612 
690,塞舌尔,33,浙江省,55813118 ,0 ,55813118 
690,塞舌尔,34,安徽省,5301621 ,0 ,5301621 
690,塞舌尔,35,福建省,18972332 ,0 ,18972332 
690,塞舌尔,36,江西省,15532305 ,0 ,15532305 
690,塞舌尔,37,山东省,50765290 ,9408 ,50774698 
690,塞舌尔,41,河南省,2902366 ,0 ,2902366 
690,塞舌尔,42,湖北省,22634226 ,0 ,22634226 
690,塞舌尔,43,湖南省,16034929 ,0 ,16034929 
690,塞舌尔,44,广东省,119735157 ,11918 ,119747075 
690,塞舌尔,45,广西壮族自治区,4015582 ,0 ,4015582 
690,塞舌尔,50,重庆市,3746271 ,0 ,3746271 
690,塞舌尔,51,四川省,5425904 ,0 ,5425904 
690,塞舌尔,52,贵州省,665198 ,0 ,665198 
690,塞舌尔,53,云南省,4149064 ,0 ,4149064 
690,塞舌尔,61,陕西省,1164997 ,0 ,1164997 
690,塞舌尔,65,新疆维吾尔自治区,196322 ,0 ,196322 
694,塞拉利昂,11,北京市,304446821 ,84738555 ,389185376 
694,塞拉利昂,12,天津市,90316301 ,685233 ,91001534 
694,塞拉利昂,13,河北省,75449263 ,217304241 ,292753504 
694,塞拉利昂,14,山西省,140207 ,35113221 ,35253428 
694,塞拉利昂,15,内蒙古自治区,3193446 ,0 ,3193446 
694,塞拉利昂,21,辽宁省,17457241 ,94836533 ,112293774 
694,塞拉利昂,22,吉林省,2681433 ,3267 ,2684700 
694,塞拉利昂,23,黑龙江省,5048357 ,39597576 ,44645933 
694,塞拉利昂,31,上海市,61894047 ,222807686 ,284701733 
694,塞拉利昂,32,江苏省,138644708 ,92293493 ,230938201 
694,塞拉利昂,33,浙江省,831462280 ,527030736 ,1358493016 
694,塞拉利昂,34,安徽省,43178458 ,0 ,43178458 
694,塞拉利昂,35,福建省,112891308 ,313359352 ,426250660 
694,塞拉利昂,36,江西省,103824386 ,720354 ,104544740 
694,塞拉利昂,37,山东省,360624797 ,226852204 ,587477001 
694,塞拉利昂,41,河南省,44909708 ,20505 ,44930213 
694,塞拉利昂,42,湖北省,47450087 ,0 ,47450087 
694,塞拉利昂,43,湖南省,119598545 ,913504554 ,1033103099 
694,塞拉利昂,44,广东省,248617220 ,627627029 ,876244249 
694,塞拉利昂,45,广西壮族自治区,24468854 ,205499973 ,229968827 
694,塞拉利昂,46,海南省,3995481 ,239863153 ,243858634 
694,塞拉利昂,50,重庆市,20560089 ,249153191 ,269713280 
694,塞拉利昂,51,四川省,19524587 ,109939062 ,129463649 
694,塞拉利昂,52,贵州省,3606740 ,0 ,3606740 
694,塞拉利昂,53,云南省,34251964 ,0 ,34251964 
694,塞拉利昂,61,陕西省,10287660 ,1202548 ,11490208 
694,塞拉利昂,62,甘肃省,10142124 ,0 ,10142124 
694,塞拉利昂,64,宁夏回族自治区,5214 ,8997573 ,9002787 
694,塞拉利昂,65,新疆维吾尔自治区,8330237 ,0 ,8330237 
702,新加坡,11,北京市,35691834553 ,13008700189 ,48700534742 
702,新加坡,12,天津市,9120381699 ,5722930807 ,14843312506 
702,新加坡,13,河北省,3032429743 ,292394488 ,3324824231 
702,新加坡,14,山西省,2701655230 ,532610790 ,3234266020 
702,新加坡,15,内蒙古自治区,170289518 ,8224280 ,178513798 
702,新加坡,21,辽宁省,20094567863 ,3669663685 ,23764231548 
702,新加坡,22,吉林省,695297691 ,123176974 ,818474665 
702,新加坡,23,黑龙江省,213295160 ,59149405 ,272444565 
702,新加坡,31,上海市,36720893899 ,33815925903 ,70536819802 
702,新加坡,32,江苏省,50453581963 ,33226268513 ,83679850476 
702,新加坡,33,浙江省,26699245660 ,13443938803 ,40143184463 
702,新加坡,34,安徽省,3429287602 ,4146495737 ,7575783339 
702,新加坡,35,福建省,12536250392 ,6260652380 ,18796902772 
702,新加坡,36,江西省,11584385722 ,770735677 ,12355121399 
702,新加坡,37,山东省,34783735575 ,6616671819 ,41400407394 
702,新加坡,41,河南省,5874017434 ,2108817634 ,7982835068 
702,新加坡,42,湖北省,4031398451 ,4140751126 ,8172149577 
702,新加坡,43,湖南省,9721221017 ,668856749 ,10390077766 
702,新加坡,44,广东省,68067298358 ,35631430202 ,103698728560 
702,新加坡,45,广西壮族自治区,3235030857 ,953381504 ,4188412361 
702,新加坡,46,海南省,1434550418 ,271739271 ,1706289689 
702,新加坡,50,重庆市,4502751954 ,2006492282 ,6509244236 
702,新加坡,51,四川省,9710589293 ,2644156311 ,12354745604 
702,新加坡,52,贵州省,1006149231 ,8514899 ,1014664130 
702,新加坡,53,云南省,3963391573 ,106805615 ,4070197188 
702,新加坡,54,西藏自治区,884390 ,123359 ,1007749 
702,新加坡,61,陕西省,6685463171 ,2444343987 ,9129807158 
702,新加坡,62,甘肃省,187150861 ,523665686 ,710816547 
702,新加坡,63,青海省,230522913 ,0 ,230522913 
702,新加坡,64,宁夏回族自治区,67343063 ,2047294 ,69390357 
702,新加坡,65,新疆维吾尔自治区,373147544 ,31887874 ,405035418 
703,斯洛伐克,11,北京市,544425764 ,1390115879 ,1934541643 
703,斯洛伐克,12,天津市,809230051 ,6957832434 ,7767062485 
703,斯洛伐克,13,河北省,148231247 ,89142513 ,237373760 
703,斯洛伐克,14,山西省,6560779 ,201209 ,6761988 
703,斯洛伐克,15,内蒙古自治区,59459 ,48051667 ,48111126 
703,斯洛伐克,21,辽宁省,99468995 ,1678199375 ,1777668370 
703,斯洛伐克,22,吉林省,51833021 ,4476604478 ,4528437499 
703,斯洛伐克,23,黑龙江省,78903408 ,45149783 ,124053191 
703,斯洛伐克,31,上海市,1436162003 ,16203396921 ,17639558924 
703,斯洛伐克,32,江苏省,4614700381 ,800430242 ,5415130623 
703,斯洛伐克,33,浙江省,2869669532 ,3606534241 ,6476203773 
703,斯洛伐克,34,安徽省,246397368 ,74484701 ,320882069 
703,斯洛伐克,35,福建省,6448620947 ,423091142 ,6871712089 
703,斯洛伐克,36,江西省,65910922 ,11567672 ,77478594 
703,斯洛伐克,37,山东省,501927133 ,234865365 ,736792498 
703,斯洛伐克,41,河南省,162546553 ,40513863 ,203060416 
703,斯洛伐克,42,湖北省,411690174 ,37903744 ,449593918 
703,斯洛伐克,43,湖南省,124350195 ,66936087 ,191286282 
703,斯洛伐克,44,广东省,2776755287 ,3109026957 ,5885782244 
703,斯洛伐克,45,广西壮族自治区,71115175 ,11591741 ,82706916 
703,斯洛伐克,46,海南省,1789172 ,1576092 ,3365264 
703,斯洛伐克,50,重庆市,344003008 ,475699679 ,819702687 
703,斯洛伐克,51,四川省,279053571 ,39411874 ,318465445 
703,斯洛伐克,52,贵州省,3945305 ,10443 ,3955748 
703,斯洛伐克,53,云南省,4624950 ,301706 ,4926656 
703,斯洛伐克,61,陕西省,144149672 ,77753105 ,221902777 
703,斯洛伐克,62,甘肃省,9844645 ,3372 ,9848017 
703,斯洛伐克,64,宁夏回族自治区,27448131 ,17443826 ,44891957 
703,斯洛伐克,65,新疆维吾尔自治区,73125971 ,11503 ,73137474 
704,越南,11,北京市,11091965484 ,16127084883 ,27219050367 
704,越南,12,天津市,11124280526 ,5337802842 ,16462083368 
704,越南,13,河北省,9214338809 ,317350884 ,9531689693 
704,越南,14,山西省,1434509376 ,1849380745 ,3283890121 
704,越南,15,内蒙古自治区,3153870081 ,13526574 ,3167396655 
704,越南,21,辽宁省,5558810462 ,1812076728 ,7370887190 
704,越南,22,吉林省,877357310 ,156908322 ,1034265632 
704,越南,23,黑龙江省,942527708 ,364854023 ,1307381731 
704,越南,31,上海市,25488716171 ,56422590603 ,81911306774 
704,越南,32,江苏省,114236513534 ,53487862506 ,167724376040 
704,越南,33,浙江省,72734949346 ,26136332292 ,98871281638 
704,越南,34,安徽省,9704518685 ,5327336189 ,15031854874 
704,越南,35,福建省,41248432948 ,10703671206 ,51952104154 
704,越南,36,江西省,20388277201 ,3573474482 ,23961751683 
704,越南,37,山东省,50109382662 ,17053447006 ,67162829668 
704,越南,41,河南省,9559705061 ,33931611477 ,43491316538 
704,越南,42,湖北省,12978063272 ,3049940742 ,16028004014 
704,越南,43,湖南省,18333788057 ,1944912396 ,20278700453 
704,越南,44,广东省,128280161886 ,98551705105 ,226831866991 
704,越南,45,广西壮族自治区,94712318170 ,26766324715 ,121478642885 
704,越南,46,海南省,3923449847 ,3275153219 ,7198603066 
704,越南,50,重庆市,11750742700 ,23396257547 ,35147000247 
704,越南,51,四川省,34587322714 ,20688379044 ,55275701758 
704,越南,52,贵州省,1058689022 ,192632230 ,1251321252 
704,越南,53,云南省,13839442517 ,2764752750 ,16604195267 
704,越南,54,西藏自治区,89394451 ,215792 ,89610243 
704,越南,61,陕西省,3697697225 ,1342355090 ,5040052315 
704,越南,62,甘肃省,212712604 ,1674561 ,214387165 
704,越南,63,青海省,101713490 ,1572547 ,103286037 
704,越南,64,宁夏回族自治区,255727114 ,7974968 ,263702082 
704,越南,65,新疆维吾尔自治区,1101627840 ,24301727 ,1125929567 
705,斯洛文尼亚,11,北京市,190549863 ,253445160 ,443995023 
705,斯洛文尼亚,12,天津市,178749547 ,69472851 ,248222398 
705,斯洛文尼亚,13,河北省,434670448 ,14484205 ,449154653 
705,斯洛文尼亚,14,山西省,25309462 ,1603783 ,26913245 
705,斯洛文尼亚,15,内蒙古自治区,27098207 ,442552 ,27540759 
705,斯洛文尼亚,21,辽宁省,255042688 ,507366568 ,762409256 
705,斯洛文尼亚,22,吉林省,62378136 ,232260013 ,294638149 
705,斯洛文尼亚,23,黑龙江省,45387722 ,22873296 ,68261018 
705,斯洛文尼亚,31,上海市,8271991134 ,552599154 ,8824590288 
705,斯洛文尼亚,32,江苏省,3542428270 ,391806206 ,3934234476 
705,斯洛文尼亚,33,浙江省,6799696948 ,271222563 ,7070919511 
705,斯洛文尼亚,34,安徽省,608104761 ,29203139 ,637307900 
705,斯洛文尼亚,35,福建省,1135345615 ,30862866 ,1166208481 
705,斯洛文尼亚,36,江西省,533693702 ,225514 ,533919216 
705,斯洛文尼亚,37,山东省,2213925305 ,152142585 ,2366067890 
705,斯洛文尼亚,41,河南省,324062778 ,6830544 ,330893322 
705,斯洛文尼亚,42,湖北省,924855486 ,25129382 ,949984868 
705,斯洛文尼亚,43,湖南省,391308062 ,20298561 ,411606623 
705,斯洛文尼亚,44,广东省,7784714064 ,359166291 ,8143880355 
705,斯洛文尼亚,45,广西壮族自治区,51765711 ,61870 ,51827581 
705,斯洛文尼亚,46,海南省,50548256 ,4677359 ,55225615 
705,斯洛文尼亚,50,重庆市,211572414 ,25313752 ,236886166 
705,斯洛文尼亚,51,四川省,223288009 ,49796629 ,273084638 
705,斯洛文尼亚,52,贵州省,25371732 ,130660 ,25502392 
705,斯洛文尼亚,53,云南省,96875817 ,36642 ,96912459 
705,斯洛文尼亚,54,西藏自治区,0 ,98042 ,98042 
705,斯洛文尼亚,61,陕西省,552372555 ,19809873 ,572182428 
705,斯洛文尼亚,62,甘肃省,14922606 ,0 ,14922606 
705,斯洛文尼亚,63,青海省,5999300 ,0 ,5999300 
705,斯洛文尼亚,64,宁夏回族自治区,54318961 ,0 ,54318961 
705,斯洛文尼亚,65,新疆维吾尔自治区,24566550 ,0 ,24566550 
706,索马里,11,北京市,17470076 ,51669 ,17521745 
706,索马里,12,天津市,67711381 ,1410964 ,69122345 
706,索马里,13,河北省,100837489 ,1221997 ,102059486 
706,索马里,14,山西省,1059174 ,0 ,1059174 
706,索马里,21,辽宁省,11670221 ,0 ,11670221 
706,索马里,22,吉林省,95619 ,0 ,95619 
706,索马里,23,黑龙江省,7358482 ,1549114 ,8907596 
706,索马里,31,上海市,110308984 ,171967 ,110480951 
706,索马里,32,江苏省,688325479 ,22784 ,688348263 
706,索马里,33,浙江省,1416673764 ,1514489 ,1418188253 
706,索马里,34,安徽省,51557343 ,3287458 ,54844801 
706,索马里,35,福建省,203749883 ,1885554 ,205635437 
706,索马里,36,江西省,120198653 ,0 ,120198653 
706,索马里,37,山东省,950042159 ,11793328 ,961835487 
706,索马里,41,河南省,96568226 ,225223 ,96793449 
706,索马里,42,湖北省,98556172 ,0 ,98556172 
706,索马里,43,湖南省,297631925 ,2204 ,297634129 
706,索马里,44,广东省,540092205 ,6385901 ,546478106 
706,索马里,45,广西壮族自治区,25385474 ,0 ,25385474 
706,索马里,46,海南省,6460552 ,0 ,6460552 
706,索马里,50,重庆市,50869068 ,0 ,50869068 
706,索马里,51,四川省,41570745 ,2490 ,41573235 
706,索马里,52,贵州省,7683861 ,0 ,7683861 
706,索马里,53,云南省,36664535 ,0 ,36664535 
706,索马里,61,陕西省,3620083 ,1868 ,3621951 
706,索马里,63,青海省,635919 ,0 ,635919 
706,索马里,65,新疆维吾尔自治区,7854488 ,0 ,7854488 
710,南非,11,北京市,2575551862 ,44677599572 ,47253151434 
710,南非,12,天津市,1919929004 ,1946042000 ,3865971004 
710,南非,13,河北省,3299146036 ,3562809681 ,6861955717 
710,南非,14,山西省,543806884 ,2543878122 ,3087685006 
710,南非,15,内蒙古自治区,279657658 ,875143832 ,1154801490 
710,南非,21,辽宁省,2055763473 ,1841761088 ,3897524561 
710,南非,22,吉林省,635915147 ,165309699 ,801224846 
710,南非,23,黑龙江省,220089360 ,100348152 ,320437512 
710,南非,31,上海市,6118868828 ,26882035396 ,33000904224 
710,南非,32,江苏省,13965640832 ,9581721144 ,23547361976 
710,南非,33,浙江省,23235146304 ,13611748172 ,36846894476 
710,南非,34,安徽省,3324390249 ,1054098724 ,4378488973 
710,南非,35,福建省,7238793158 ,9486148724 ,16724941882 
710,南非,36,江西省,2517863518 ,2300505325 ,4818368843 
710,南非,37,山东省,11294232784 ,3246043965 ,14540276749 
710,南非,41,河南省,2619775683 ,437425217 ,3057200900 
710,南非,42,湖北省,2025769844 ,4981180808 ,7006950652 
710,南非,43,湖南省,5559513554 ,5548192677 ,11107706231 
710,南非,44,广东省,22230457062 ,28794478058 ,51024935120 
710,南非,45,广西壮族自治区,594286711 ,4152715069 ,4747001780 
710,南非,46,海南省,93702727 ,1136248676 ,1229951403 
710,南非,50,重庆市,2239427350 ,750968011 ,2990395361 
710,南非,51,四川省,2256344029 ,1845445972 ,4101790001 
710,南非,52,贵州省,392884103 ,534954686 ,927838789 
710,南非,53,云南省,582952803 ,853007863 ,1435960666 
710,南非,54,西藏自治区,22181640 ,0 ,22181640 
710,南非,61,陕西省,405416391 ,605785357 ,1011201748 
710,南非,62,甘肃省,111069877 ,642524870 ,753594747 
710,南非,63,青海省,32491532 ,219786808 ,252278340 
710,南非,64,宁夏回族自治区,28423372 ,276458862 ,304882234 
710,南非,65,新疆维吾尔自治区,432815975 ,9313600 ,442129575 
716,津巴布韦,11,北京市,728283945 ,3498984582 ,4227268527 
716,津巴布韦,12,天津市,31883492 ,59343787 ,91227279 
716,津巴布韦,13,河北省,78275583 ,16892544 ,95168127 
716,津巴布韦,14,山西省,20144293 ,237446579 ,257590872 
716,津巴布韦,15,内蒙古自治区,14866683 ,15924386 ,30791069 
716,津巴布韦,21,辽宁省,121554732 ,333671594 ,455226326 
716,津巴布韦,22,吉林省,56007500 ,8905 ,56016405 
716,津巴布韦,23,黑龙江省,2261637 ,0 ,2261637 
716,津巴布韦,31,上海市,170799376 ,94607689 ,265407065 
716,津巴布韦,32,江苏省,572942315 ,164357979 ,737300294 
716,津巴布韦,33,浙江省,1108841658 ,1078480033 ,2187321691 
716,津巴布韦,34,安徽省,102798350 ,2018215 ,104816565 
716,津巴布韦,35,福建省,104845150 ,449585414 ,554430564 
716,津巴布韦,36,江西省,40196087 ,103959496 ,144155583 
716,津巴布韦,37,山东省,632187898 ,41877936 ,674065834 
716,津巴布韦,41,河南省,184574492 ,11188245 ,195762737 
716,津巴布韦,42,湖北省,56897127 ,0 ,56897127 
716,津巴布韦,43,湖南省,98352641 ,6657243 ,105009884 
716,津巴布韦,44,广东省,598313976 ,54170609 ,652484585 
716,津巴布韦,45,广西壮族自治区,26515276 ,1054 ,26516330 
716,津巴布韦,46,海南省,116102098 ,21361205 ,137463303 
716,津巴布韦,50,重庆市,185129538 ,0 ,185129538 
716,津巴布韦,51,四川省,92723176 ,32940349 ,125663525 
716,津巴布韦,52,贵州省,5279420 ,0 ,5279420 
716,津巴布韦,53,云南省,16027755 ,3295 ,16031050 
716,津巴布韦,61,陕西省,85270701 ,274845 ,85545546 
716,津巴布韦,62,甘肃省,2185067 ,1669799 ,3854866 
716,津巴布韦,63,青海省,547260 ,0 ,547260 
716,津巴布韦,64,宁夏回族自治区,582309 ,0 ,582309 
716,津巴布韦,65,新疆维吾尔自治区,1051709 ,0 ,1051709 
724,西班牙,11,北京市,3889150809 ,3982610485 ,7871761294 
724,西班牙,12,天津市,2172310454 ,2018773374 ,4191083828 
724,西班牙,13,河北省,3532986548 ,284700152 ,3817686700 
724,西班牙,14,山西省,443346448 ,223383516 ,666729964 
724,西班牙,15,内蒙古自治区,336323571 ,49949861 ,386273432 
724,西班牙,21,辽宁省,2043536689 ,1758340325 ,3801877014 
724,西班牙,22,吉林省,881542656 ,544507109 ,1426049765 
724,西班牙,23,黑龙江省,566748425 ,277961166 ,844709591 
724,西班牙,31,上海市,11987792433 ,9234586172 ,21222378605 
724,西班牙,32,江苏省,29009499430 ,4552645818 ,33562145248 
724,西班牙,33,浙江省,46881789668 ,5063529892 ,51945319560 
724,西班牙,34,安徽省,4593707331 ,1278191801 ,5871899132 
724,西班牙,35,福建省,16003112024 ,2828022353 ,18831134377 
724,西班牙,36,江西省,4277188677 ,174333669 ,4451522346 
724,西班牙,37,山东省,15347921265 ,2669583125 ,18017504390 
724,西班牙,41,河南省,2309859520 ,1636434105 ,3946293625 
724,西班牙,42,湖北省,2523042217 ,245724447 ,2768766664 
724,西班牙,43,湖南省,2705085101 ,328804085 ,3033889186 
724,西班牙,44,广东省,43579171748 ,6478103574 ,50057275322 
724,西班牙,45,广西壮族自治区,894272277 ,1084993607 ,1979265884 
724,西班牙,46,海南省,962521583 ,662273738 ,1624795321 
724,西班牙,50,重庆市,3135886980 ,238632091 ,3374519071 
724,西班牙,51,四川省,4714523996 ,783863694 ,5498387690 
724,西班牙,52,贵州省,192027030 ,71256450 ,263283480 
724,西班牙,53,云南省,772911085 ,2003480478 ,2776391563 
724,西班牙,54,西藏自治区,407401 ,96708 ,504109 
724,西班牙,61,陕西省,4353278178 ,87424473 ,4440702651 
724,西班牙,62,甘肃省,39738000 ,13055290 ,52793290 
724,西班牙,63,青海省,9061022 ,6128307 ,15189329 
724,西班牙,64,宁夏回族自治区,86574708 ,2336334 ,88911042 
724,西班牙,65,新疆维吾尔自治区,277531314 ,1975553 ,279506867 
728,南苏丹共和国,11,北京市,145413459 ,1512351806 ,1657765265 
728,南苏丹共和国,12,天津市,109123383 ,0 ,109123383 
728,南苏丹共和国,13,河北省,15836891 ,0 ,15836891 
728,南苏丹共和国,14,山西省,3189257 ,0 ,3189257 
728,南苏丹共和国,21,辽宁省,27488418 ,0 ,27488418 
728,南苏丹共和国,23,黑龙江省,58959632 ,0 ,58959632 
728,南苏丹共和国,31,上海市,7450496 ,2941 ,7453437 
728,南苏丹共和国,32,江苏省,22115829 ,10066 ,22125895 
728,南苏丹共和国,33,浙江省,41059601 ,746 ,41060347 
728,南苏丹共和国,34,安徽省,15100628 ,0 ,15100628 
728,南苏丹共和国,35,福建省,14084426 ,0 ,14084426 
728,南苏丹共和国,36,江西省,4749345 ,0 ,4749345 
728,南苏丹共和国,37,山东省,107433945 ,2987 ,107436932 
728,南苏丹共和国,41,河南省,15728192 ,0 ,15728192 
728,南苏丹共和国,42,湖北省,479182 ,0 ,479182 
728,南苏丹共和国,43,湖南省,1969526 ,0 ,1969526 
728,南苏丹共和国,44,广东省,88250397 ,0 ,88250397 
728,南苏丹共和国,45,广西壮族自治区,8073106 ,0 ,8073106 
728,南苏丹共和国,46,海南省,3278260 ,0 ,3278260 
728,南苏丹共和国,50,重庆市,3475573 ,0 ,3475573 
728,南苏丹共和国,51,四川省,1221926 ,0 ,1221926 
728,南苏丹共和国,61,陕西省,1325810 ,0 ,1325810 
728,南苏丹共和国,62,甘肃省,167549 ,0 ,167549 
729,苏丹,11,北京市,128892302 ,545849232 ,674741534 
729,苏丹,12,天津市,225036421 ,392540758 ,617577179 
729,苏丹,13,河北省,247378770 ,31449439 ,278828209 
729,苏丹,14,山西省,2169034 ,0 ,2169034 
729,苏丹,15,内蒙古自治区,11163387 ,9806183 ,20969570 
729,苏丹,21,辽宁省,18190199 ,85592747 ,103782946 
729,苏丹,22,吉林省,1545381 ,0 ,1545381 
729,苏丹,23,黑龙江省,18995583 ,0 ,18995583 
729,苏丹,31,上海市,380877389 ,81169086 ,462046475 
729,苏丹,32,江苏省,638638348 ,36027914 ,674666262 
729,苏丹,33,浙江省,2574998971 ,18207005 ,2593205976 
729,苏丹,34,安徽省,148070677 ,1522713919 ,1670784596 
729,苏丹,35,福建省,458375038 ,424206025 ,882581063 
729,苏丹,36,江西省,328696925 ,509 ,328697434 
729,苏丹,37,山东省,984996533 ,1452818204 ,2437814737 
729,苏丹,41,河南省,150545740 ,70532532 ,221078272 
729,苏丹,42,湖北省,156920038 ,231789 ,157151827 
729,苏丹,43,湖南省,509209909 ,746 ,509210655 
729,苏丹,44,广东省,1674776150 ,96774515 ,1771550665 
729,苏丹,45,广西壮族自治区,75038110 ,16164421 ,91202531 
729,苏丹,46,海南省,12884248 ,33795687 ,46679935 
729,苏丹,50,重庆市,54241292 ,0 ,54241292 
729,苏丹,51,四川省,410388202 ,4032 ,410392234 
729,苏丹,52,贵州省,14854237 ,0 ,14854237 
729,苏丹,53,云南省,49311382 ,0 ,49311382 
729,苏丹,61,陕西省,35246310 ,57345322 ,92591632 
729,苏丹,62,甘肃省,52885333 ,536 ,52885869 
729,苏丹,64,宁夏回族自治区,700148 ,0 ,700148 
729,苏丹,65,新疆维吾尔自治区,49456293 ,0 ,49456293 
732,西撒哈拉,11,北京市,0 ,292 ,292 
732,西撒哈拉,12,天津市,1977376 ,0 ,1977376 
732,西撒哈拉,31,上海市,78 ,0 ,78 
732,西撒哈拉,33,浙江省,120459 ,0 ,120459 
732,西撒哈拉,36,江西省,1350559 ,0 ,1350559 
732,西撒哈拉,37,山东省,2835065 ,0 ,2835065 
732,西撒哈拉,44,广东省,197 ,3882 ,4079 
740,苏里南,11,北京市,14342117 ,46285491 ,60627608 
740,苏里南,12,天津市,32178625 ,2271120 ,34449745 
740,苏里南,13,河北省,26480264 ,0 ,26480264 
740,苏里南,14,山西省,1319101 ,0 ,1319101 
740,苏里南,15,内蒙古自治区,1444402 ,0 ,1444402 
740,苏里南,21,辽宁省,5625296 ,306978 ,5932274 
740,苏里南,23,黑龙江省,89980 ,0 ,89980 
740,苏里南,31,上海市,30379615 ,24672612 ,55052227 
740,苏里南,32,江苏省,139182716 ,57571001 ,196753717 
740,苏里南,33,浙江省,511658220 ,14212910 ,525871130 
740,苏里南,34,安徽省,25589006 ,0 ,25589006 
740,苏里南,35,福建省,100102722 ,11220762 ,111323484 
740,苏里南,36,江西省,48177175 ,909815 ,49086990 
740,苏里南,37,山东省,162679919 ,2508677 ,165188596 
740,苏里南,41,河南省,11744241 ,0 ,11744241 
740,苏里南,42,湖北省,31375024 ,0 ,31375024 
740,苏里南,43,湖南省,65362578 ,32233993 ,97596571 
740,苏里南,44,广东省,237981198 ,58185468 ,296166666 
740,苏里南,45,广西壮族自治区,17202309 ,627544 ,17829853 
740,苏里南,46,海南省,2024118 ,0 ,2024118 
740,苏里南,50,重庆市,12295300 ,0 ,12295300 
740,苏里南,51,四川省,14649169 ,128 ,14649297 
740,苏里南,52,贵州省,24915849 ,0 ,24915849 
740,苏里南,53,云南省,13179216 ,0 ,13179216 
740,苏里南,61,陕西省,1984657 ,0 ,1984657 
740,苏里南,65,新疆维吾尔自治区,2189637 ,891446 ,3081083 
748,斯威士兰,11,北京市,1740499 ,98175 ,1838674 
748,斯威士兰,12,天津市,313805 ,42722 ,356527 
748,斯威士兰,13,河北省,5174668 ,0 ,5174668 
748,斯威士兰,21,辽宁省,1629411 ,0 ,1629411 
748,斯威士兰,23,黑龙江省,194736 ,0 ,194736 
748,斯威士兰,31,上海市,14612409 ,362778 ,14975187 
748,斯威士兰,32,江苏省,61712285 ,969368 ,62681653 
748,斯威士兰,33,浙江省,64220972 ,23582 ,64244554 
748,斯威士兰,34,安徽省,50008480 ,7263 ,50015743 
748,斯威士兰,35,福建省,1592208 ,1189027 ,2781235 
748,斯威士兰,36,江西省,44309095 ,423 ,44309518 
748,斯威士兰,37,山东省,64940268 ,6335 ,64946603 
748,斯威士兰,41,河南省,1284438 ,0 ,1284438 
748,斯威士兰,42,湖北省,19053848 ,30 ,19053878 
748,斯威士兰,43,湖南省,3533142 ,0 ,3533142 
748,斯威士兰,44,广东省,38417439 ,1335117 ,39752556 
748,斯威士兰,45,广西壮族自治区,15970 ,0 ,15970 
748,斯威士兰,50,重庆市,5352 ,0 ,5352 
748,斯威士兰,51,四川省,4787199 ,905 ,4788104 
748,斯威士兰,61,陕西省,1105337 ,9362 ,1114699 
752,瑞典,11,北京市,989747699 ,4947167957 ,5936915656 
752,瑞典,12,天津市,1728965952 ,1071713064 ,2800679016 
752,瑞典,13,河北省,967712721 ,979016129 ,1946728850 
752,瑞典,14,山西省,32838782 ,67738597 ,100577379 
752,瑞典,15,内蒙古自治区,94845960 ,619279558 ,714125518 
752,瑞典,21,辽宁省,691054807 ,429991735 ,1121046542 
752,瑞典,22,吉林省,103272632 ,272419661 ,375692293 
752,瑞典,23,黑龙江省,85086848 ,422532661 ,507619509 
752,瑞典,31,上海市,3430493403 ,15748375067 ,19178868470 
752,瑞典,32,江苏省,13198074883 ,9613785850 ,22811860733 
752,瑞典,33,浙江省,12933691948 ,2237564459 ,15171256407 
752,瑞典,34,安徽省,1408388980 ,335533977 ,1743922957 
752,瑞典,35,福建省,2929292484 ,547679800 ,3476972284 
752,瑞典,36,江西省,524976589 ,112058960 ,637035549 
752,瑞典,37,山东省,4517355132 ,2006468946 ,6523824078 
752,瑞典,41,河南省,521111021 ,482844563 ,1003955584 
752,瑞典,42,湖北省,494529255 ,478575949 ,973105204 
752,瑞典,43,湖南省,332354450 ,166546185 ,498900635 
752,瑞典,44,广东省,11750732011 ,3229771623 ,14980503634 
752,瑞典,45,广西壮族自治区,205589578 ,272474795 ,478064373 
752,瑞典,46,海南省,73287061 ,112293105 ,185580166 
752,瑞典,50,重庆市,858208213 ,424725212 ,1282933425 
752,瑞典,51,四川省,709744656 ,976791950 ,1686536606 
752,瑞典,52,贵州省,95567605 ,8741189 ,104308794 
752,瑞典,53,云南省,61151173 ,146028117 ,207179290 
752,瑞典,54,西藏自治区,1096 ,0 ,1096 
752,瑞典,61,陕西省,256791439 ,245580339 ,502371778 
752,瑞典,62,甘肃省,2084052 ,35324553 ,37408605 
752,瑞典,63,青海省,5598286 ,0 ,5598286 
752,瑞典,64,宁夏回族自治区,6999508 ,124410969 ,131410477 
752,瑞典,65,新疆维吾尔自治区,24553318 ,29465979 ,54019297 
756,瑞士,11,北京市,520059971 ,82801453667 ,83321513638 
756,瑞士,12,天津市,1150922127 ,1391384509 ,2542306636 
756,瑞士,13,河北省,312375777 ,135990467 ,448366244 
756,瑞士,14,山西省,31452916 ,46212918 ,77665834 
756,瑞士,15,内蒙古自治区,55376918 ,25452142 ,80829060 
756,瑞士,21,辽宁省,724492811 ,848360208 ,1572853019 
756,瑞士,22,吉林省,139381054 ,344930634 ,484311688 
756,瑞士,23,黑龙江省,12201683 ,85030838 ,97232521 
756,瑞士,31,上海市,7159677815 ,82882352409 ,90042030224 
756,瑞士,32,江苏省,6634120197 ,9184149379 ,15818269576 
756,瑞士,33,浙江省,5399690712 ,6196406399 ,11596097111 
756,瑞士,34,安徽省,1032791117 ,203041435 ,1235832552 
756,瑞士,35,福建省,1224740200 ,12257857488 ,13482597688 
756,瑞士,36,江西省,218258025 ,176850414 ,395108439 
756,瑞士,37,山东省,1362241103 ,1647861590 ,3010102693 
756,瑞士,41,河南省,266156345 ,249270609 ,515426954 
756,瑞士,42,湖北省,211968524 ,413142500 ,625111024 
756,瑞士,43,湖南省,213583990 ,1422736645 ,1636320635 
756,瑞士,44,广东省,7821560298 ,24293342549 ,32114902847 
756,瑞士,45,广西壮族自治区,531943019 ,34060530 ,566003549 
756,瑞士,46,海南省,21458975 ,2506397450 ,2527856425 
756,瑞士,50,重庆市,3338820701 ,442452327 ,3781273028 
756,瑞士,51,四川省,262331222 ,321752084 ,584083306 
756,瑞士,52,贵州省,69813048 ,1972054 ,71785102 
756,瑞士,53,云南省,82727728 ,250494837 ,333222565 
756,瑞士,54,西藏自治区,45084 ,125032 ,170116 
756,瑞士,61,陕西省,150547242 ,376488981 ,527036223 
756,瑞士,62,甘肃省,15359084 ,13953729 ,29312813 
756,瑞士,63,青海省,15828492 ,2019350 ,17847842 
756,瑞士,64,宁夏回族自治区,2084621 ,177164189 ,179248810 
756,瑞士,65,新疆维吾尔自治区,22879048 ,16111382 ,38990430 
760,叙利亚,11,北京市,85638861 ,4213 ,85643074 
760,叙利亚,12,天津市,34266959 ,7183469 ,41450428 
760,叙利亚,13,河北省,11161038 ,206 ,11161244 
760,叙利亚,14,山西省,2099894 ,0 ,2099894 
760,叙利亚,15,内蒙古自治区,570231 ,0 ,570231 
760,叙利亚,21,辽宁省,8815234 ,3525 ,8818759 
760,叙利亚,22,吉林省,604114 ,0 ,604114 
760,叙利亚,23,黑龙江省,8675859 ,0 ,8675859 
760,叙利亚,31,上海市,60244668 ,3475907 ,63720575 
760,叙利亚,32,江苏省,199731891 ,1357147 ,201089038 
760,叙利亚,33,浙江省,830531141 ,1207494 ,831738635 
760,叙利亚,34,安徽省,38319579 ,1388 ,38320967 
760,叙利亚,35,福建省,102758767 ,11928 ,102770695 
760,叙利亚,36,江西省,58803784 ,0 ,58803784 
760,叙利亚,37,山东省,274845525 ,91142 ,274936667 
760,叙利亚,41,河南省,20700001 ,0 ,20700001 
760,叙利亚,42,湖北省,26504071 ,0 ,26504071 
760,叙利亚,43,湖南省,33453398 ,0 ,33453398 
760,叙利亚,44,广东省,192876453 ,117246 ,192993699 
760,叙利亚,45,广西壮族自治区,8524412 ,0 ,8524412 
760,叙利亚,50,重庆市,17661978 ,0 ,17661978 
760,叙利亚,51,四川省,13149341 ,0 ,13149341 
760,叙利亚,52,贵州省,2149214 ,0 ,2149214 
760,叙利亚,53,云南省,29597677 ,0 ,29597677 
760,叙利亚,54,西藏自治区,872399 ,0 ,872399 
760,叙利亚,61,陕西省,5380287 ,0 ,5380287 
760,叙利亚,62,甘肃省,4538470 ,248 ,4538718 
760,叙利亚,64,宁夏回族自治区,0 ,239861 ,239861 
760,叙利亚,65,新疆维吾尔自治区,31361360 ,0 ,31361360 
762,塔吉克斯坦,11,北京市,153065159 ,11844 ,153077003 
762,塔吉克斯坦,12,天津市,114482647 ,111481498 ,225964145 
762,塔吉克斯坦,13,河北省,56120051 ,7373 ,56127424 
762,塔吉克斯坦,14,山西省,8576184 ,0 ,8576184 
762,塔吉克斯坦,15,内蒙古自治区,319878 ,0 ,319878 
762,塔吉克斯坦,21,辽宁省,15911459 ,513 ,15911972 
762,塔吉克斯坦,22,吉林省,72275 ,0 ,72275 
762,塔吉克斯坦,23,黑龙江省,5289779 ,0 ,5289779 
762,塔吉克斯坦,31,上海市,119565311 ,535579247 ,655144558 
762,塔吉克斯坦,32,江苏省,515524640 ,57992 ,515582632 
762,塔吉克斯坦,33,浙江省,706071559 ,89702378 ,795773937 
762,塔吉克斯坦,34,安徽省,61693681 ,6745642 ,68439323 
762,塔吉克斯坦,35,福建省,40439699 ,909228157 ,949667856 
762,塔吉克斯坦,36,江西省,197605863 ,30233 ,197636096 
762,塔吉克斯坦,37,山东省,603432567 ,2409 ,603434976 
762,塔吉克斯坦,41,河南省,42090092 ,0 ,42090092 
762,塔吉克斯坦,42,湖北省,247417334 ,79175936 ,326593270 
762,塔吉克斯坦,43,湖南省,105487050 ,58529570 ,164016620 
762,塔吉克斯坦,44,广东省,226616742 ,57857 ,226674599 
762,塔吉克斯坦,45,广西壮族自治区,52243934 ,0 ,52243934 
762,塔吉克斯坦,46,海南省,82965719 ,0 ,82965719 
762,塔吉克斯坦,50,重庆市,6239805 ,0 ,6239805 
762,塔吉克斯坦,51,四川省,42636712 ,136 ,42636848 
762,塔吉克斯坦,52,贵州省,78 ,0 ,78 
762,塔吉克斯坦,53,云南省,60505 ,0 ,60505 
762,塔吉克斯坦,54,西藏自治区,2699893 ,0 ,2699893 
762,塔吉克斯坦,61,陕西省,139697331 ,15145620 ,154842951 
762,塔吉克斯坦,63,青海省,3872002 ,0 ,3872002 
762,塔吉克斯坦,64,宁夏回族自治区,28345113 ,0 ,28345113 
762,塔吉克斯坦,65,新疆维吾尔自治区,7407706795 ,256173150 ,7663879945 
764,泰国,11,北京市,5949091876 ,10672795879 ,16621887755 
764,泰国,12,天津市,5840436160 ,4122314833 ,9962750993 
764,泰国,13,河北省,7402192144 ,754393696 ,8156585840 
764,泰国,14,山西省,1905901435 ,97440555 ,2003341990 
764,泰国,15,内蒙古自治区,2351334090 ,196173865 ,2547507955 
764,泰国,21,辽宁省,4023260295 ,1838860815 ,5862121110 
764,泰国,22,吉林省,463276321 ,670649691 ,1133926012 
764,泰国,23,黑龙江省,456317870 ,157129529 ,613447399 
764,泰国,31,上海市,27207839098 ,37562667849 ,64770506947 
764,泰国,32,江苏省,60038015216 ,35037238092 ,95075253308 
764,泰国,33,浙江省,53631180554 ,25898732425 ,79529912979 
764,泰国,34,安徽省,8105186117 ,4619789870 ,12724975987 
764,泰国,35,福建省,26607047119 ,11344757110 ,37951804229 
764,泰国,36,江西省,10341349082 ,2035168674 ,12376517756 
764,泰国,37,山东省,31612497358 ,23541152951 ,55153650309 
764,泰国,41,河南省,7869144543 ,1689148680 ,9558293223 
764,泰国,42,湖北省,8474560179 ,2359127809 ,10833687988 
764,泰国,43,湖南省,10917091305 ,4431574017 ,15348665322 
764,泰国,44,广东省,76026064339 ,90380747562 ,166406811901 
764,泰国,45,广西壮族自治区,8985953887 ,9794035691 ,18779989578 
764,泰国,46,海南省,764861963 ,1374750294 ,2139612257 
764,泰国,50,重庆市,6079358564 ,8619161567 ,14698520131 
764,泰国,51,四川省,6604012336 ,2327686508 ,8931698844 
764,泰国,52,贵州省,1136317983 ,843010681 ,1979328664 
764,泰国,53,云南省,6704090790 ,6424054539 ,13128145329 
764,泰国,54,西藏自治区,2627004 ,18039 ,2645043 
764,泰国,61,陕西省,2129941732 ,139917605 ,2269859337 
764,泰国,62,甘肃省,140139769 ,4928915 ,145068684 
764,泰国,63,青海省,48705517 ,0 ,48705517 
764,泰国,64,宁夏回族自治区,395048027 ,7504426 ,402552453 
764,泰国,65,新疆维吾尔自治区,645006487 ,8346317 ,653352804 
768,多哥,11,北京市,157003833 ,68726256 ,225730089 
768,多哥,12,天津市,162084350 ,65560042 ,227644392 
768,多哥,13,河北省,216491393 ,10034684 ,226526077 
768,多哥,14,山西省,2268011 ,0 ,2268011 
768,多哥,15,内蒙古自治区,5574333 ,0 ,5574333 
768,多哥,21,辽宁省,57112492 ,1765 ,57114257 
768,多哥,23,黑龙江省,19484863 ,2017814 ,21502677 
768,多哥,31,上海市,266378540 ,28577584 ,294956124 
768,多哥,32,江苏省,845945107 ,40948784 ,886893891 
768,多哥,33,浙江省,3526807724 ,192231482 ,3719039206 
768,多哥,34,安徽省,368809913 ,414406054 ,783215967 
768,多哥,35,福建省,759881021 ,71999687 ,831880708 
768,多哥,36,江西省,665371369 ,2612613 ,667983982 
768,多哥,37,山东省,2637439048 ,135540546 ,2772979594 
768,多哥,41,河南省,292327872 ,14572786 ,306900658 
768,多哥,42,湖北省,293195762 ,53726335 ,346922097 
768,多哥,43,湖南省,706233784 ,38 ,706233822 
768,多哥,44,广东省,3489688989 ,20991485 ,3510680474 
768,多哥,45,广西壮族自治区,63599104 ,75117288 ,138716392 
768,多哥,46,海南省,2128187 ,76007 ,2204194 
768,多哥,50,重庆市,308834054 ,2308 ,308836362 
768,多哥,51,四川省,361294589 ,3161 ,361297750 
768,多哥,52,贵州省,50377364 ,0 ,50377364 
768,多哥,53,云南省,78004752 ,0 ,78004752 
768,多哥,61,陕西省,38668968 ,0 ,38668968 
768,多哥,62,甘肃省,4791191 ,0 ,4791191 
768,多哥,63,青海省,657145 ,0 ,657145 
768,多哥,64,宁夏回族自治区,2521460 ,0 ,2521460 
768,多哥,65,新疆维吾尔自治区,12618865 ,0 ,12618865 
776,汤加,11,北京市,20094325 ,2833 ,20097158 
776,汤加,12,天津市,2174780 ,0 ,2174780 
776,汤加,13,河北省,3468622 ,0 ,3468622 
776,汤加,21,辽宁省,247810 ,0 ,247810 
776,汤加,23,黑龙江省,315652 ,0 ,315652 
776,汤加,31,上海市,2369968 ,6682 ,2376650 
776,汤加,32,江苏省,47508156 ,0 ,47508156 
776,汤加,33,浙江省,104175496 ,0 ,104175496 
776,汤加,34,安徽省,3629673 ,0 ,3629673 
776,汤加,35,福建省,28277391 ,0 ,28277391 
776,汤加,36,江西省,7235651 ,0 ,7235651 
776,汤加,37,山东省,19673822 ,0 ,19673822 
776,汤加,41,河南省,1307543 ,0 ,1307543 
776,汤加,42,湖北省,2723636 ,0 ,2723636 
776,汤加,43,湖南省,9449573 ,0 ,9449573 
776,汤加,44,广东省,30734121 ,323 ,30734444 
776,汤加,45,广西壮族自治区,961122 ,0 ,961122 
776,汤加,50,重庆市,1117796 ,0 ,1117796 
776,汤加,51,四川省,2388452 ,0 ,2388452 
776,汤加,52,贵州省,1347484 ,0 ,1347484 
776,汤加,61,陕西省,1096 ,0 ,1096 
776,汤加,65,新疆维吾尔自治区,396357 ,0 ,396357 
780,特立尼达和多巴哥,11,北京市,22686530 ,933781064 ,956467594 
780,特立尼达和多巴哥,12,天津市,38713940 ,0 ,38713940 
780,特立尼达和多巴哥,13,河北省,73461886 ,198553 ,73660439 
780,特立尼达和多巴哥,14,山西省,913017 ,0 ,913017 
780,特立尼达和多巴哥,15,内蒙古自治区,3388613 ,0 ,3388613 
780,特立尼达和多巴哥,21,辽宁省,50965555 ,227476570 ,278442125 
780,特立尼达和多巴哥,22,吉林省,272600 ,0 ,272600 
780,特立尼达和多巴哥,23,黑龙江省,3803850 ,0 ,3803850 
780,特立尼达和多巴哥,31,上海市,137794004 ,71772848 ,209566852 
780,特立尼达和多巴哥,32,江苏省,245157301 ,1248287374 ,1493444675 
780,特立尼达和多巴哥,33,浙江省,596877517 ,229889769 ,826767286 
780,特立尼达和多巴哥,34,安徽省,56536039 ,0 ,56536039 
780,特立尼达和多巴哥,35,福建省,108851024 ,166756943 ,275607967 
780,特立尼达和多巴哥,36,江西省,67213910 ,0 ,67213910 
780,特立尼达和多巴哥,37,山东省,571297951 ,2770 ,571300721 
780,特立尼达和多巴哥,41,河南省,50568681 ,171 ,50568852 
780,特立尼达和多巴哥,42,湖北省,38646446 ,0 ,38646446 
780,特立尼达和多巴哥,43,湖南省,77110952 ,0 ,77110952 
780,特立尼达和多巴哥,44,广东省,481801635 ,216893678 ,698695313 
780,特立尼达和多巴哥,45,广西壮族自治区,8390054 ,0 ,8390054 
780,特立尼达和多巴哥,46,海南省,8283195 ,346453621 ,354736816 
780,特立尼达和多巴哥,50,重庆市,16283751 ,0 ,16283751 
780,特立尼达和多巴哥,51,四川省,21010998 ,4357 ,21015355 
780,特立尼达和多巴哥,52,贵州省,2848669 ,0 ,2848669 
780,特立尼达和多巴哥,53,云南省,5017194 ,0 ,5017194 
780,特立尼达和多巴哥,61,陕西省,6387682 ,0 ,6387682 
780,特立尼达和多巴哥,62,甘肃省,1176228 ,0 ,1176228 
780,特立尼达和多巴哥,65,新疆维吾尔自治区,2122946 ,582 ,2123528 
784,阿联酋,11,北京市,11963321020 ,68983178645 ,80946499665 
784,阿联酋,12,天津市,3994057499 ,1117591426 ,5111648925 
784,阿联酋,13,河北省,4765530940 ,1456182340 ,6221713280 
784,阿联酋,14,山西省,1413975833 ,4220 ,1413980053 
784,阿联酋,15,内蒙古自治区,656173475 ,684940 ,656858415 
784,阿联酋,21,辽宁省,2563846288 ,21778126994 ,24341973282 
784,阿联酋,22,吉林省,505549505 ,19152355 ,524701860 
784,阿联酋,23,黑龙江省,558428327 ,1208969288 ,1767397615 
784,阿联酋,31,上海市,13291405931 ,7182816310 ,20474222241 
784,阿联酋,32,江苏省,27114668161 ,1092366188 ,28207034349 
784,阿联酋,33,浙江省,53783067411 ,40936251727 ,94719319138 
784,阿联酋,34,安徽省,4217070617 ,1881221684 ,6098292301 
784,阿联酋,35,福建省,11645316747 ,7075112055 ,18720428802 
784,阿联酋,36,江西省,6821534417 ,111580373 ,6933114790 
784,阿联酋,37,山东省,23782856027 ,36109466593 ,59892322620 
784,阿联酋,41,河南省,6892595217 ,14023536 ,6906618753 
784,阿联酋,42,湖北省,4338100339 ,406952635 ,4745052974 
784,阿联酋,43,湖南省,6804475062 ,1090723253 ,7895198315 
784,阿联酋,44,广东省,53095696327 ,12608036052 ,65703732379 
784,阿联酋,45,广西壮族自治区,1666533024 ,1683597736 ,3350130760 
784,阿联酋,46,海南省,1191937230 ,3157678734 ,4349615964 
784,阿联酋,50,重庆市,6664337185 ,51951304 ,6716288489 
784,阿联酋,51,四川省,6275132271 ,802804235 ,7077936506 
784,阿联酋,52,贵州省,577121826 ,456254539 ,1033376365 
784,阿联酋,53,云南省,1363188319 ,1337711184 ,2700899503 
784,阿联酋,54,西藏自治区,1382286 ,0 ,1382286 
784,阿联酋,61,陕西省,1009057631 ,47541038 ,1056598669 
784,阿联酋,62,甘肃省,531098456 ,485196 ,531583652 
784,阿联酋,63,青海省,33295903 ,0 ,33295903 
784,阿联酋,64,宁夏回族自治区,53223585 ,69433 ,53293018 
784,阿联酋,65,新疆维吾尔自治区,610740060 ,10211773 ,620951833 
788,突尼斯,11,北京市,257655806 ,62989394 ,320645200 
788,突尼斯,12,天津市,130830112 ,20609978 ,151440090 
788,突尼斯,13,河北省,344581437 ,20880919 ,365462356 
788,突尼斯,14,山西省,9582668 ,0 ,9582668 
788,突尼斯,15,内蒙古自治区,10218800 ,1419648 ,11638448 
788,突尼斯,21,辽宁省,46250656 ,26634989 ,72885645 
788,突尼斯,22,吉林省,3191060 ,13388803 ,16579863 
788,突尼斯,23,黑龙江省,16340041 ,340184 ,16680225 
788,突尼斯,31,上海市,457924265 ,692894055 ,1150818320 
788,突尼斯,32,江苏省,1105317184 ,79238695 ,1184555879 
788,突尼斯,33,浙江省,2123608418 ,110557621 ,2234166039 
788,突尼斯,34,安徽省,337670151 ,2191007 ,339861158 
788,突尼斯,35,福建省,294422904 ,62395802 ,356818706 
788,突尼斯,36,江西省,224876462 ,6133691 ,231010153 
788,突尼斯,37,山东省,723065166 ,11893362 ,734958528 
788,突尼斯,41,河南省,136344915 ,785047 ,137129962 
788,突尼斯,42,湖北省,301888031 ,5406087 ,307294118 
788,突尼斯,43,湖南省,276612503 ,562514 ,277175017 
788,突尼斯,44,广东省,2043407949 ,132238260 ,2175646209 
788,突尼斯,45,广西壮族自治区,56528996 ,3343290 ,59872286 
788,突尼斯,46,海南省,5912758 ,36121670 ,42034428 
788,突尼斯,50,重庆市,320618154 ,6318819 ,326936973 
788,突尼斯,51,四川省,133406622 ,13857535 ,147264157 
788,突尼斯,52,贵州省,15785548 ,746 ,15786294 
788,突尼斯,53,云南省,11804910 ,63 ,11804973 
788,突尼斯,54,西藏自治区,1182452 ,0 ,1182452 
788,突尼斯,61,陕西省,53648166 ,3205857 ,56854023 
788,突尼斯,62,甘肃省,199554 ,0 ,199554 
788,突尼斯,63,青海省,1447371 ,0 ,1447371 
788,突尼斯,64,宁夏回族自治区,1547607 ,0 ,1547607 
788,突尼斯,65,新疆维吾尔自治区,5147211 ,0 ,5147211 
792,土耳其,11,北京市,5865308416 ,1461649998 ,7326958414 
792,土耳其,12,天津市,2474695675 ,776142212 ,3250837887 
792,土耳其,13,河北省,4170824612 ,213789139 ,4384613751 
792,土耳其,14,山西省,2138847325 ,79484954 ,2218332279 
792,土耳其,15,内蒙古自治区,599126627 ,81492209 ,680618836 
792,土耳其,21,辽宁省,2781474213 ,569089153 ,3350563366 
792,土耳其,22,吉林省,570498635 ,241473101 ,811971736 
792,土耳其,23,黑龙江省,677753135 ,33777223 ,711530358 
792,土耳其,31,上海市,8695044923 ,3715699523 ,12410744446 
792,土耳其,32,江苏省,27558197529 ,1665078606 ,29223276135 
792,土耳其,33,浙江省,31982992926 ,3714866639 ,35697859565 
792,土耳其,34,安徽省,3518161311 ,353571134 ,3871732445 
792,土耳其,35,福建省,7015354850 ,3323014309 ,10338369159 
792,土耳其,36,江西省,2769609552 ,87997494 ,2857607046 
792,土耳其,37,山东省,15092478145 ,1229518295 ,16321996440 
792,土耳其,41,河南省,4748180798 ,706745258 ,5454926056 
792,土耳其,42,湖北省,2628385471 ,129082203 ,2757467674 
792,土耳其,43,湖南省,2623717099 ,208291676 ,2832008775 
792,土耳其,44,广东省,28034824350 ,2324654643 ,30359478993 
792,土耳其,45,广西壮族自治区,752999233 ,556540527 ,1309539760 
792,土耳其,46,海南省,551669725 ,57802418 ,609472143 
792,土耳其,50,重庆市,3503602536 ,173179014 ,3676781550 
792,土耳其,51,四川省,5119307751 ,379544086 ,5498851837 
792,土耳其,52,贵州省,529318212 ,9326865 ,538645077 
792,土耳其,53,云南省,515692469 ,161478750 ,677171219 
792,土耳其,54,西藏自治区,26602881 ,31714 ,26634595 
792,土耳其,61,陕西省,1040124696 ,15258605 ,1055383301 
792,土耳其,62,甘肃省,115605840 ,267337918 ,382943758 
792,土耳其,63,青海省,1080865 ,121569295 ,122650160 
792,土耳其,64,宁夏回族自治区,466305959 ,24309978 ,490615937 
792,土耳其,65,新疆维吾尔自治区,1008114179 ,53049741 ,1061163920 
795,土库曼斯坦,11,北京市,511433947 ,48064229607 ,48575663554 
795,土库曼斯坦,12,天津市,39816463 ,11640074 ,51456537 
795,土库曼斯坦,13,河北省,73441905 ,15000313 ,88442218 
795,土库曼斯坦,14,山西省,186219 ,0 ,186219 
795,土库曼斯坦,15,内蒙古自治区,13223902 ,4603075 ,17826977 
795,土库曼斯坦,21,辽宁省,10146258 ,0 ,10146258 
795,土库曼斯坦,23,黑龙江省,38141422 ,219153 ,38360575 
795,土库曼斯坦,31,上海市,41694205 ,14901500 ,56595705 
795,土库曼斯坦,32,江苏省,182248272 ,123862299 ,306110571 
795,土库曼斯坦,33,浙江省,963069404 ,81664180 ,1044733584 
795,土库曼斯坦,34,安徽省,606999030 ,0 ,606999030 
795,土库曼斯坦,35,福建省,20259274 ,0 ,20259274 
795,土库曼斯坦,36,江西省,44993384 ,2425197 ,47418581 
795,土库曼斯坦,37,山东省,400381850 ,54641983 ,455023833 
795,土库曼斯坦,41,河南省,58937409 ,103531 ,59040940 
795,土库曼斯坦,42,湖北省,33507555 ,0 ,33507555 
795,土库曼斯坦,43,湖南省,51514002 ,0 ,51514002 
795,土库曼斯坦,44,广东省,472783527 ,5392 ,472788919 
795,土库曼斯坦,45,广西壮族自治区,34550802 ,0 ,34550802 
795,土库曼斯坦,46,海南省,4210242 ,3617834 ,7828076 
795,土库曼斯坦,50,重庆市,26451591 ,0 ,26451591 
795,土库曼斯坦,51,四川省,220828706 ,0 ,220828706 
795,土库曼斯坦,52,贵州省,432625 ,0 ,432625 
795,土库曼斯坦,53,云南省,8036209 ,0 ,8036209 
795,土库曼斯坦,61,陕西省,7209228 ,0 ,7209228 
795,土库曼斯坦,62,甘肃省,295004 ,0 ,295004 
795,土库曼斯坦,64,宁夏回族自治区,34436071 ,0 ,34436071 
795,土库曼斯坦,65,新疆维吾尔自治区,145147866 ,12979606 ,158127472 
798,图瓦卢,11,北京市,13948851 ,0 ,13948851 
798,图瓦卢,12,天津市,4249421 ,0 ,4249421 
798,图瓦卢,21,辽宁省,98281 ,0 ,98281 
798,图瓦卢,31,上海市,5242506 ,1787 ,5244293 
798,图瓦卢,32,江苏省,15686627 ,0 ,15686627 
798,图瓦卢,33,浙江省,49558131 ,767 ,49558898 
798,图瓦卢,34,安徽省,1178847 ,0 ,1178847 
798,图瓦卢,35,福建省,63275780 ,0 ,63275780 
798,图瓦卢,36,江西省,616903 ,0 ,616903 
798,图瓦卢,37,山东省,2741176 ,0 ,2741176 
798,图瓦卢,41,河南省,707367 ,0 ,707367 
798,图瓦卢,42,湖北省,13458901 ,0 ,13458901 
798,图瓦卢,43,湖南省,2865849 ,0 ,2865849 
798,图瓦卢,44,广东省,12431832 ,22510 ,12454342 
798,图瓦卢,50,重庆市,1365194 ,0 ,1365194 
798,图瓦卢,51,四川省,1300234 ,0 ,1300234 
798,图瓦卢,52,贵州省,39 ,0 ,39 
798,图瓦卢,61,陕西省,8144 ,0 ,8144 
798,图瓦卢,65,新疆维吾尔自治区,39 ,0 ,39 
800,乌干达,11,北京市,325366864 ,17495350 ,342862214 
800,乌干达,12,天津市,99530051 ,10079016 ,109609067 
800,乌干达,13,河北省,141400457 ,15105330 ,156505787 
800,乌干达,14,山西省,9073052 ,0 ,9073052 
800,乌干达,15,内蒙古自治区,128 ,1639 ,1767 
800,乌干达,21,辽宁省,66738021 ,179030 ,66917051 
800,乌干达,22,吉林省,18333914 ,0 ,18333914 
800,乌干达,23,黑龙江省,2488256 ,884378 ,3372634 
800,乌干达,31,上海市,342316300 ,14798111 ,357114411 
800,乌干达,32,江苏省,605664831 ,47305575 ,652970406 
800,乌干达,33,浙江省,800336920 ,18869035 ,819205955 
800,乌干达,34,安徽省,161884867 ,38108219 ,199993086 
800,乌干达,35,福建省,99790758 ,16534021 ,116324779 
800,乌干达,36,江西省,84248928 ,1989 ,84250917 
800,乌干达,37,山东省,549851964 ,53770687 ,603622651 
800,乌干达,41,河南省,232060739 ,3125879 ,235186618 
800,乌干达,42,湖北省,62076865 ,4649215 ,66726080 
800,乌干达,43,湖南省,146748442 ,5320 ,146753762 
800,乌干达,44,广东省,957777429 ,30287349 ,988064778 
800,乌干达,45,广西壮族自治区,69117928 ,4349583 ,73467511 
800,乌干达,46,海南省,1072242 ,0 ,1072242 
800,乌干达,50,重庆市,63433848 ,126 ,63433974 
800,乌干达,51,四川省,143843695 ,5616 ,143849311 
800,乌干达,52,贵州省,14372778 ,0 ,14372778 
800,乌干达,53,云南省,9686761 ,7241635 ,16928396 
800,乌干达,61,陕西省,134521636 ,366 ,134522002 
800,乌干达,62,甘肃省,761455 ,0 ,761455 
800,乌干达,64,宁夏回族自治区,338 ,843 ,1181 
800,乌干达,65,新疆维吾尔自治区,57158915 ,0 ,57158915 
804,乌克兰,11,北京市,330803368 ,5461594472 ,5792397840 
804,乌克兰,12,天津市,283282351 ,89483028 ,372765379 
804,乌克兰,13,河北省,301105895 ,373312115 ,674418010 
804,乌克兰,14,山西省,90708515 ,398423776 ,489132291 
804,乌克兰,15,内蒙古自治区,17377486 ,9341424 ,26718910 
804,乌克兰,21,辽宁省,145136264 ,171444029 ,316580293 
804,乌克兰,22,吉林省,43892299 ,7759320 ,51651619 
804,乌克兰,23,黑龙江省,72876125 ,89289043 ,162165168 
804,乌克兰,31,上海市,805356565 ,1157952019 ,1963308584 
804,乌克兰,32,江苏省,1893825152 ,2156115239 ,4049940391 
804,乌克兰,33,浙江省,5152948855 ,757068786 ,5910017641 
804,乌克兰,34,安徽省,328477256 ,558787228 ,887264484 
804,乌克兰,35,福建省,660671959 ,3935081299 ,4595753258 
804,乌克兰,36,江西省,263947580 ,57454816 ,321402396 
804,乌克兰,37,山东省,1735866548 ,2650505867 ,4386372415 
804,乌克兰,41,河南省,302353738 ,121395116 ,423748854 
804,乌克兰,42,湖北省,120843522 ,39611310 ,160454832 
804,乌克兰,43,湖南省,207908049 ,564395210 ,772303259 
804,乌克兰,44,广东省,3738659266 ,1178528662 ,4917187928 
804,乌克兰,45,广西壮族自治区,77241935 ,1726588077 ,1803830012 
804,乌克兰,46,海南省,56924625 ,224195614 ,281120239 
804,乌克兰,50,重庆市,378881324 ,35272215 ,414153539 
804,乌克兰,51,四川省,315832324 ,389448048 ,705280372 
804,乌克兰,52,贵州省,18925736 ,80352560 ,99278296 
804,乌克兰,53,云南省,66024161 ,262208013 ,328232174 
804,乌克兰,54,西藏自治区,11739799 ,0 ,11739799 
804,乌克兰,61,陕西省,80643719 ,57165013 ,137808732 
804,乌克兰,62,甘肃省,535710 ,98288822 ,98824532 
804,乌克兰,63,青海省,39 ,0 ,39 
804,乌克兰,64,宁夏回族自治区,8595364 ,0 ,8595364 
804,乌克兰,65,新疆维吾尔自治区,173351096 ,6991916 ,180343012 
807,北马其顿共和国,11,北京市,92604544 ,19216739 ,111821283 
807,北马其顿共和国,12,天津市,32327405 ,8327629 ,40655034 
807,北马其顿共和国,13,河北省,4829701 ,1956167 ,6785868 
807,北马其顿共和国,14,山西省,752671 ,250871364 ,251624035 
807,北马其顿共和国,15,内蒙古自治区,1007676 ,1902934 ,2910610 
807,北马其顿共和国,21,辽宁省,4972543 ,49676137 ,54648680 
807,北马其顿共和国,22,吉林省,503272 ,88683763 ,89187035 
807,北马其顿共和国,23,黑龙江省,426122 ,429202 ,855324 
807,北马其顿共和国,31,上海市,145804060 ,219237342 ,365041402 
807,北马其顿共和国,32,江苏省,180528429 ,23683045 ,204211474 
807,北马其顿共和国,33,浙江省,250149496 ,8255522 ,258405018 
807,北马其顿共和国,34,安徽省,17383932 ,460666 ,17844598 
807,北马其顿共和国,35,福建省,16569517 ,141138334 ,157707851 
807,北马其顿共和国,36,江西省,9942495 ,924 ,9943419 
807,北马其顿共和国,37,山东省,122705481 ,77109282 ,199814763 
807,北马其顿共和国,41,河南省,3999306 ,824996 ,4824302 
807,北马其顿共和国,42,湖北省,9437165 ,1454 ,9438619 
807,北马其顿共和国,43,湖南省,14924645 ,446026 ,15370671 
807,北马其顿共和国,44,广东省,231345114 ,36241701 ,267586815 
807,北马其顿共和国,45,广西壮族自治区,4875174 ,262896 ,5138070 
807,北马其顿共和国,46,海南省,149922 ,258414 ,408336 
807,北马其顿共和国,50,重庆市,35146915 ,2335 ,35149250 
807,北马其顿共和国,51,四川省,17994871 ,1320901 ,19315772 
807,北马其顿共和国,52,贵州省,1594021 ,0 ,1594021 
807,北马其顿共和国,53,云南省,1309393 ,210179 ,1519572 
807,北马其顿共和国,61,陕西省,3842399 ,577 ,3842976 
807,北马其顿共和国,62,甘肃省,1458282 ,0 ,1458282 
807,北马其顿共和国,63,青海省,2745856 ,0 ,2745856 
807,北马其顿共和国,64,宁夏回族自治区,28 ,0 ,28 
807,北马其顿共和国,65,新疆维吾尔自治区,155770 ,0 ,155770 
818,埃及,11,北京市,3218842781 ,1868731898 ,5087574679 
818,埃及,12,天津市,1244174587 ,136762095 ,1380936682 
818,埃及,13,河北省,1397147870 ,45938017 ,1443085887 
818,埃及,14,山西省,121543335 ,0 ,121543335 
818,埃及,15,内蒙古自治区,494030265 ,0 ,494030265 
818,埃及,21,辽宁省,565488247 ,50017326 ,615505573 
818,埃及,22,吉林省,122598929 ,2253 ,122601182 
818,埃及,23,黑龙江省,131046127 ,20237276 ,151283403 
818,埃及,31,上海市,3583030457 ,277335462 ,3860365919 
818,埃及,32,江苏省,9749938228 ,493587383 ,10243525611 
818,埃及,33,浙江省,22360437719 ,499944736 ,22860382455 
818,埃及,34,安徽省,2487993445 ,40391706 ,2528385151 
818,埃及,35,福建省,3523248473 ,179017515 ,3702265988 
818,埃及,36,江西省,2181436926 ,10570417 ,2192007343 
818,埃及,37,山东省,7917874099 ,723094295 ,8640968394 
818,埃及,41,河南省,1268112787 ,11792655 ,1279905442 
818,埃及,42,湖北省,1367931996 ,190101 ,1368122097 
818,埃及,43,湖南省,1961931275 ,2324391 ,1964255666 
818,埃及,44,广东省,16262890267 ,265440209 ,16528330476 
818,埃及,45,广西壮族自治区,612038023 ,49253591 ,661291614 
818,埃及,46,海南省,388394045 ,1069698 ,389463743 
818,埃及,50,重庆市,570110443 ,23434253 ,593544696 
818,埃及,51,四川省,1122900315 ,22156739 ,1145057054 
818,埃及,52,贵州省,114766113 ,0 ,114766113 
818,埃及,53,云南省,455507469 ,493825 ,456001294 
818,埃及,54,西藏自治区,5315491 ,0 ,5315491 
818,埃及,61,陕西省,424229731 ,3264032 ,427493763 
818,埃及,62,甘肃省,31273719 ,624 ,31274343 
818,埃及,63,青海省,10501057 ,0 ,10501057 
818,埃及,64,宁夏回族自治区,99394882 ,2399 ,99397281 
818,埃及,65,新疆维吾尔自治区,120592639 ,32384156 ,152976795 
826,英国,11,北京市,4719517037 ,28205312134 ,32924829171 
826,英国,12,天津市,3956489348 ,9254212611 ,13210701959 
826,英国,13,河北省,4041009321 ,317409161 ,4358418482 
826,英国,14,山西省,3011674402 ,37185134 ,3048859536 
826,英国,15,内蒙古自治区,458088217 ,89965189 ,548053406 
826,英国,21,辽宁省,4871594901 ,1410346156 ,6281941057 
826,英国,22,吉林省,489214398 ,127504109 ,616718507 
826,英国,23,黑龙江省,286596003 ,264267168 ,550863171 
826,英国,31,上海市,37728403214 ,26248433026 ,63976836240 
826,英国,32,江苏省,57817947947 ,8242920612 ,66060868559 
826,英国,33,浙江省,69538974865 ,8546915135 ,78085890000 
826,英国,34,安徽省,8177438833 ,690028009 ,8867466842 
826,英国,35,福建省,20130707106 ,1803290366 ,21933997472 
826,英国,36,江西省,7041652430 ,539554249 ,7581206679 
826,英国,37,山东省,32632937649 ,5344424230 ,37977361879 
826,英国,41,河南省,13358421402 ,635596003 ,13994017405 
826,英国,42,湖北省,4479936927 ,817701003 ,5297637930 
826,英国,43,湖南省,7014598234 ,345358064 ,7359956298 
826,英国,44,广东省,98207113783 ,11421800192 ,109628913975 
826,英国,45,广西壮族自治区,2310413151 ,250078215 ,2560491366 
826,英国,46,海南省,132116045 ,3333714918 ,3465830963 
826,英国,50,重庆市,8014444965 ,751823717 ,8766268682 
826,英国,51,四川省,8290162045 ,806020550 ,9096182595 
826,英国,52,贵州省,358360718 ,119104071 ,477464789 
826,英国,53,云南省,2145500921 ,143853005 ,2289353926 
826,英国,54,西藏自治区,114104 ,2995871 ,3109975 
826,英国,61,陕西省,1425934727 ,416353400 ,1842288127 
826,英国,62,甘肃省,89913602 ,208671292 ,298584894 
826,英国,63,青海省,7234308 ,1580268 ,8814576 
826,英国,64,宁夏回族自治区,628755800 ,54237990 ,682993790 
826,英国,65,新疆维吾尔自治区,340714807 ,93238968 ,433953775 
834,坦桑尼亚,11,北京市,830752822 ,509769824 ,1340522646 
834,坦桑尼亚,12,天津市,597797735 ,108597151 ,706394886 
834,坦桑尼亚,13,河北省,930032264 ,66649380 ,996681644 
834,坦桑尼亚,14,山西省,17381462 ,15184 ,17396646 
834,坦桑尼亚,15,内蒙古自治区,77732248 ,0 ,77732248 
834,坦桑尼亚,21,辽宁省,177025833 ,18787931 ,195813764 
834,坦桑尼亚,22,吉林省,592571728 ,0 ,592571728 
834,坦桑尼亚,23,黑龙江省,35524691 ,1521217 ,37045908 
834,坦桑尼亚,31,上海市,630610533 ,579812547 ,1210423080 
834,坦桑尼亚,32,江苏省,2995612212 ,91635401 ,3087247613 
834,坦桑尼亚,33,浙江省,9162189103 ,310222285 ,9472411388 
834,坦桑尼亚,34,安徽省,624376579 ,284020438 ,908397017 
834,坦桑尼亚,35,福建省,1648489986 ,38797045 ,1687287031 
834,坦桑尼亚,36,江西省,1166097481 ,1132803 ,1167230284 
834,坦桑尼亚,37,山东省,5272621310 ,332280842 ,5604902152 
834,坦桑尼亚,41,河南省,548471172 ,168185591 ,716656763 
834,坦桑尼亚,42,湖北省,912945080 ,53962428 ,966907508 
834,坦桑尼亚,43,湖南省,1534742375 ,2393826 ,1537136201 
834,坦桑尼亚,44,广东省,6328900476 ,161833381 ,6490733857 
834,坦桑尼亚,45,广西壮族自治区,268441207 ,7043917 ,275485124 
834,坦桑尼亚,46,海南省,50232122 ,1258424 ,51490546 
834,坦桑尼亚,50,重庆市,557622599 ,208553375 ,766175974 
834,坦桑尼亚,51,四川省,996298067 ,91695 ,996389762 
834,坦桑尼亚,52,贵州省,69505194 ,0 ,69505194 
834,坦桑尼亚,53,云南省,255772505 ,2317158 ,258089663 
834,坦桑尼亚,61,陕西省,111555081 ,30096 ,111585177 
834,坦桑尼亚,62,甘肃省,11715837 ,6865 ,11722702 
834,坦桑尼亚,63,青海省,4262744 ,0 ,4262744 
834,坦桑尼亚,64,宁夏回族自治区,2142876 ,0 ,2142876 
834,坦桑尼亚,65,新疆维吾尔自治区,101231422 ,0 ,101231422 
840,美国,11,北京市,25528934599 ,182012419232 ,207541353831 
840,美国,12,天津市,36651428329 ,38253262207 ,74904690536 
840,美国,13,河北省,32031041019 ,11604957852 ,43635998871 
840,美国,14,山西省,29407860093 ,430503903 ,29838363996 
840,美国,15,内蒙古自治区,2714028954 ,2394751149 ,5108780103 
840,美国,21,辽宁省,26103679875 ,23486474243 ,49590154118 
840,美国,22,吉林省,1960625104 ,2510579174 ,4471204278 
840,美国,23,黑龙江省,2524395694 ,2519149195 ,5043544889 
840,美国,31,上海市,235657963577 ,149305945679 ,384963909256 
840,美国,32,江苏省,447866624396 ,91204920938 ,539071545334 
840,美国,33,浙江省,445721325048 ,59070791239 ,504792116287 
840,美国,34,安徽省,61362379415 ,16404450639 ,77766830054 
840,美国,35,福建省,162903409170 ,37514775158 ,200418184328 
840,美国,36,江西省,56510940794 ,2986670189 ,59497610983 
840,美国,37,山东省,220216897526 ,49440771461 ,269657668987 
840,美国,41,河南省,125924767917 ,4179523759 ,130104291676 
840,美国,42,湖北省,42391840795 ,11831386791 ,54223227586 
840,美国,43,湖南省,51251597469 ,5979393473 ,57230990942 
840,美国,44,广东省,692021716777 ,84271019810 ,776292736587 
840,美国,45,广西壮族自治区,21384385152 ,8351046624 ,29735431776 
840,美国,46,海南省,3201108415 ,7925329549 ,11126437964 
840,美国,50,重庆市,77105813734 ,10631313581 ,87737127315 
840,美国,51,四川省,90397906651 ,49671295633 ,140069202284 
840,美国,52,贵州省,2652487482 ,552599214 ,3205086696 
840,美国,53,云南省,15159753334 ,1795830089 ,16955583423 
840,美国,54,西藏自治区,10977350 ,42720150 ,53697500 
840,美国,61,陕西省,18774598046 ,9752747143 ,28527345189 
840,美国,62,甘肃省,848525785 ,127772703 ,976298488 
840,美国,63,青海省,93478126 ,11877539 ,105355665 
840,美国,64,宁夏回族自治区,1746690388 ,225212950 ,1971903338 
840,美国,65,新疆维吾尔自治区,1139809458 ,641527344 ,1781336802 
854,布基纳法索,11,北京市,132433031 ,125282643 ,257715674 
854,布基纳法索,12,天津市,99423767 ,1710451 ,101134218 
854,布基纳法索,13,河北省,107848887 ,7310864 ,115159751 
854,布基纳法索,14,山西省,8015224 ,0 ,8015224 
854,布基纳法索,15,内蒙古自治区,295313 ,0 ,295313 
854,布基纳法索,21,辽宁省,5110092 ,158 ,5110250 
854,布基纳法索,22,吉林省,64 ,0 ,64 
854,布基纳法索,23,黑龙江省,39593 ,0 ,39593 
854,布基纳法索,31,上海市,78939410 ,7714980 ,86654390 
854,布基纳法索,32,江苏省,227155528 ,88297493 ,315453021 
854,布基纳法索,33,浙江省,264689317 ,8699 ,264698016 
854,布基纳法索,34,安徽省,27097037 ,125381847 ,152478884 
854,布基纳法索,35,福建省,190904122 ,137713080 ,328617202 
854,布基纳法索,36,江西省,19371198 ,459 ,19371657 
854,布基纳法索,37,山东省,355250391 ,39577411 ,394827802 
854,布基纳法索,41,河南省,42325739 ,10461205 ,52786944 
854,布基纳法索,42,湖北省,35349281 ,27817505 ,63166786 
854,布基纳法索,43,湖南省,69328250 ,0 ,69328250 
854,布基纳法索,44,广东省,533925127 ,8566171 ,542491298 
854,布基纳法索,45,广西壮族自治区,58021861 ,1214 ,58023075 
854,布基纳法索,46,海南省,16143100 ,0 ,16143100 
854,布基纳法索,50,重庆市,192594637 ,0 ,192594637 
854,布基纳法索,51,四川省,5453349 ,8166 ,5461515 
854,布基纳法索,52,贵州省,1553939 ,0 ,1553939 
854,布基纳法索,53,云南省,7612989 ,0 ,7612989 
854,布基纳法索,61,陕西省,102262588 ,0 ,102262588 
854,布基纳法索,64,宁夏回族自治区,3170323 ,0 ,3170323 
854,布基纳法索,65,新疆维吾尔自治区,6445424 ,610224 ,7055648 
858,乌拉圭,11,北京市,286892165 ,1208474255 ,1495366420 
858,乌拉圭,12,天津市,90573260 ,1638589963 ,1729163223 
858,乌拉圭,13,河北省,249602562 ,73410400 ,323012962 
858,乌拉圭,14,山西省,41631653 ,21036969 ,62668622 
858,乌拉圭,15,内蒙古自治区,12830454 ,154634350 ,167464804 
858,乌拉圭,21,辽宁省,71499900 ,303646335 ,375146235 
858,乌拉圭,22,吉林省,6624844 ,165546494 ,172171338 
858,乌拉圭,23,黑龙江省,11791620 ,322054501 ,333846121 
858,乌拉圭,31,上海市,916079002 ,2418458085 ,3334537087 
858,乌拉圭,32,江苏省,1811145133 ,4686088713 ,6497233846 
858,乌拉圭,33,浙江省,3288822944 ,520629405 ,3809452349 
858,乌拉圭,34,安徽省,374871914 ,1407159816 ,1782031730 
858,乌拉圭,35,福建省,582808869 ,1811809554 ,2394618423 
858,乌拉圭,36,江西省,365789041 ,68548997 ,434338038 
858,乌拉圭,37,山东省,1598329640 ,2988240110 ,4586569750 
858,乌拉圭,41,河南省,222922993 ,98337329 ,321260322 
858,乌拉圭,42,湖北省,239080218 ,423811642 ,662891860 
858,乌拉圭,43,湖南省,367519494 ,593983150 ,961502644 
858,乌拉圭,44,广东省,3042113861 ,2006049001 ,5048162862 
858,乌拉圭,45,广西壮族自治区,115612282 ,461968872 ,577581154 
858,乌拉圭,46,海南省,83126345 ,245816204 ,328942549 
858,乌拉圭,50,重庆市,285186584 ,840492159 ,1125678743 
858,乌拉圭,51,四川省,203315801 ,144076551 ,347392352 
858,乌拉圭,52,贵州省,32722641 ,52678403 ,85401044 
858,乌拉圭,53,云南省,227979880 ,289984917 ,517964797 
858,乌拉圭,61,陕西省,36502881 ,0 ,36502881 
858,乌拉圭,62,甘肃省,0 ,18776777 ,18776777 
858,乌拉圭,63,青海省,0 ,8767638 ,8767638 
858,乌拉圭,64,宁夏回族自治区,5037806 ,0 ,5037806 
858,乌拉圭,65,新疆维吾尔自治区,9593852 ,14162255 ,23756107 
860,乌兹别克斯坦,11,北京市,1302611106 ,7662026325 ,8964637431 
860,乌兹别克斯坦,12,天津市,658224888 ,337767384 ,995992272 
860,乌兹别克斯坦,13,河北省,552301830 ,94997716 ,647299546 
860,乌兹别克斯坦,14,山西省,51333882 ,3476 ,51337358 
860,乌兹别克斯坦,15,内蒙古自治区,237604884 ,0 ,237604884 
860,乌兹别克斯坦,21,辽宁省,386497443 ,28767314 ,415264757 
860,乌兹别克斯坦,22,吉林省,75712352 ,779636 ,76491988 
860,乌兹别克斯坦,23,黑龙江省,181115129 ,6113636 ,187228765 
860,乌兹别克斯坦,31,上海市,1626222654 ,142347767 ,1768570421 
860,乌兹别克斯坦,32,江苏省,4715359768 ,119386468 ,4834746236 
860,乌兹别克斯坦,33,浙江省,8974754723 ,751242429 ,9725997152 
860,乌兹别克斯坦,34,安徽省,881342777 ,84026875 ,965369652 
860,乌兹别克斯坦,35,福建省,643800093 ,1128074777 ,1771874870 
860,乌兹别克斯坦,36,江西省,340246049 ,12100787 ,352346836 
860,乌兹别克斯坦,37,山东省,3982632474 ,179867802 ,4162500276 
860,乌兹别克斯坦,41,河南省,784060622 ,196917250 ,980977872 
860,乌兹别克斯坦,42,湖北省,965577750 ,291007 ,965868757 
860,乌兹别克斯坦,43,湖南省,629956826 ,57253790 ,687210616 
860,乌兹别克斯坦,44,广东省,3563121066 ,57436366 ,3620557432 
860,乌兹别克斯坦,45,广西壮族自治区,42307297 ,521560 ,42828857 
860,乌兹别克斯坦,46,海南省,31241497 ,0 ,31241497 
860,乌兹别克斯坦,50,重庆市,275483260 ,0 ,275483260 
860,乌兹别克斯坦,51,四川省,398038675 ,2150607 ,400189282 
860,乌兹别克斯坦,52,贵州省,39014307 ,0 ,39014307 
860,乌兹别克斯坦,53,云南省,12364960 ,25224170 ,37589130 
860,乌兹别克斯坦,54,西藏自治区,2579395 ,0 ,2579395 
860,乌兹别克斯坦,61,陕西省,333928594 ,101251568 ,435180162 
860,乌兹别克斯坦,62,甘肃省,17492141 ,86587283 ,104079424 
860,乌兹别克斯坦,63,青海省,37193290 ,72767 ,37266057 
860,乌兹别克斯坦,64,宁夏回族自治区,312169283 ,0 ,312169283 
860,乌兹别克斯坦,65,新疆维吾尔自治区,4190923921 ,156380479 ,4347304400 
862,委内瑞拉,11,北京市,920391620 ,294549242 ,1214940862 
862,委内瑞拉,12,天津市,80615164 ,36103079 ,116718243 
862,委内瑞拉,13,河北省,190681834 ,53046972 ,243728806 
862,委内瑞拉,14,山西省,3238362 ,0 ,3238362 
862,委内瑞拉,15,内蒙古自治区,14742511 ,0 ,14742511 
862,委内瑞拉,21,辽宁省,55099463 ,135649446 ,190748909 
862,委内瑞拉,22,吉林省,21065121 ,0 ,21065121 
862,委内瑞拉,23,黑龙江省,25499021 ,0 ,25499021 
862,委内瑞拉,31,上海市,527295602 ,222970814 ,750266416 
862,委内瑞拉,32,江苏省,818506856 ,558954038 ,1377460894 
862,委内瑞拉,33,浙江省,3167259365 ,812540946 ,3979800311 
862,委内瑞拉,34,安徽省,427593349 ,1598014 ,429191363 
862,委内瑞拉,35,福建省,787916547 ,421554464 ,1209471011 
862,委内瑞拉,36,江西省,357715840 ,52723865 ,410439705 
862,委内瑞拉,37,山东省,1579290670 ,488385951 ,2067676621 
862,委内瑞拉,41,河南省,264360636 ,1823401 ,266184037 
862,委内瑞拉,42,湖北省,275577069 ,191157449 ,466734518 
862,委内瑞拉,43,湖南省,403866258 ,4181296 ,408047554 
862,委内瑞拉,44,广东省,3598060178 ,177590722 ,3775650900 
862,委内瑞拉,45,广西壮族自治区,85775035 ,1606160 ,87381195 
862,委内瑞拉,46,海南省,4757132 ,90626602 ,95383734 
862,委内瑞拉,50,重庆市,250828100 ,287126598 ,537954698 
862,委内瑞拉,51,四川省,289871085 ,128941239 ,418812324 
862,委内瑞拉,52,贵州省,26875149 ,0 ,26875149 
862,委内瑞拉,53,云南省,112057458 ,0 ,112057458 
862,委内瑞拉,54,西藏自治区,2196585 ,0 ,2196585 
862,委内瑞拉,61,陕西省,14052309 ,0 ,14052309 
862,委内瑞拉,63,青海省,4614285 ,0 ,4614285 
862,委内瑞拉,64,宁夏回族自治区,16880136 ,0 ,16880136 
862,委内瑞拉,65,新疆维吾尔自治区,14497473 ,138613476 ,153110949 
887,也门,11,北京市,22902822 ,3876400910 ,3899303732 
887,也门,12,天津市,165465760 ,0 ,165465760 
887,也门,13,河北省,383128343 ,10856 ,383139199 
887,也门,14,山西省,13784818 ,0 ,13784818 
887,也门,15,内蒙古自治区,15911228 ,0 ,15911228 
887,也门,21,辽宁省,64688571 ,0 ,64688571 
887,也门,22,吉林省,5254894 ,0 ,5254894 
887,也门,23,黑龙江省,8195493 ,0 ,8195493 
887,也门,31,上海市,124853631 ,52847 ,124906478 
887,也门,32,江苏省,987680763 ,130982 ,987811745 
887,也门,33,浙江省,5809678234 ,80359707 ,5890037941 
887,也门,34,安徽省,207047429 ,0 ,207047429 
887,也门,35,福建省,904459708 ,723 ,904460431 
887,也门,36,江西省,299956214 ,0 ,299956214 
887,也门,37,山东省,1026285992 ,2386699 ,1028672691 
887,也门,41,河南省,105779196 ,0 ,105779196 
887,也门,42,湖北省,303818355 ,0 ,303818355 
887,也门,43,湖南省,771543295 ,0 ,771543295 
887,也门,44,广东省,1639783250 ,226731 ,1640009981 
887,也门,45,广西壮族自治区,62331246 ,0 ,62331246 
887,也门,46,海南省,2796754 ,0 ,2796754 
887,也门,50,重庆市,78232005 ,0 ,78232005 
887,也门,51,四川省,69043772 ,18740 ,69062512 
887,也门,52,贵州省,57991937 ,0 ,57991937 
887,也门,53,云南省,128778852 ,0 ,128778852 
887,也门,61,陕西省,10629656 ,0 ,10629656 
887,也门,62,甘肃省,17193572 ,0 ,17193572 
887,也门,63,青海省,2815123 ,0 ,2815123 
887,也门,64,宁夏回族自治区,86355 ,20479 ,106834 
887,也门,65,新疆维吾尔自治区,55889453 ,0 ,55889453 
894,赞比亚,11,北京市,568087618 ,642417017 ,1210504635 
894,赞比亚,12,天津市,69578022 ,171652332 ,241230354 
894,赞比亚,13,河北省,101819940 ,14018 ,101833958 
894,赞比亚,14,山西省,4498283 ,251993552 ,256491835 
894,赞比亚,15,内蒙古自治区,361437 ,60622245 ,60983682 
894,赞比亚,21,辽宁省,81882167 ,89534992 ,171417159 
894,赞比亚,22,吉林省,26456 ,159152138 ,159178594 
894,赞比亚,23,黑龙江省,4629460 ,0 ,4629460 
894,赞比亚,31,上海市,158155238 ,999153939 ,1157309177 
894,赞比亚,32,江苏省,753551648 ,2400513333 ,3154064981 
894,赞比亚,33,浙江省,454612682 ,2667059935 ,3121672617 
894,赞比亚,34,安徽省,83065731 ,2736883500 ,2819949231 
894,赞比亚,35,福建省,123027190 ,1399048462 ,1522075652 
894,赞比亚,36,江西省,127700871 ,4335895671 ,4463596542 
894,赞比亚,37,山东省,785882251 ,5856157976 ,6642040227 
894,赞比亚,41,河南省,138251724 ,337949979 ,476201703 
894,赞比亚,42,湖北省,93217974 ,1184041679 ,1277259653 
894,赞比亚,43,湖南省,68606378 ,193789820 ,262396198 
894,赞比亚,44,广东省,589349114 ,4088373077 ,4677722191 
894,赞比亚,45,广西壮族自治区,47253158 ,2394084174 ,2441337332 
894,赞比亚,46,海南省,11004200 ,29861368 ,40865568 
894,赞比亚,50,重庆市,133161977 ,85876705 ,219038682 
894,赞比亚,51,四川省,56873914 ,20111984 ,76985898 
894,赞比亚,52,贵州省,1408986 ,9295854 ,10704840 
894,赞比亚,53,云南省,15387605 ,166088979 ,181476584 
894,赞比亚,54,西藏自治区,7 ,0 ,7 
894,赞比亚,61,陕西省,131619342 ,25107973 ,156727315 
894,赞比亚,62,甘肃省,0 ,325778139 ,325778139 
894,赞比亚,64,宁夏回族自治区,12727 ,15531 ,28258 
894,赞比亚,65,新疆维吾尔自治区,19567143 ,0 ,19567143 
999,北美洲其他国家(地区),11,北京市,94348 ,1656 ,96004 
999,北美洲其他国家(地区),12,天津市,5634 ,0 ,5634 
999,北美洲其他国家(地区),13,河北省,2192 ,0 ,2192 
999,北美洲其他国家(地区),21,辽宁省,686 ,2187 ,2873 
999,北美洲其他国家(地区),31,上海市,220123 ,16096 ,236219 
999,北美洲其他国家(地区),32,江苏省,6856 ,0 ,6856 
999,北美洲其他国家(地区),33,浙江省,16707 ,0 ,16707 
999,北美洲其他国家(地区),34,安徽省,7 ,0 ,7 
999,北美洲其他国家(地区),35,福建省,13992 ,76 ,14068 
999,北美洲其他国家(地区),37,山东省,39536 ,2979 ,42515 
999,北美洲其他国家(地区),41,河南省,8540 ,0 ,8540 
999,北美洲其他国家(地区),42,湖北省,34542 ,0 ,34542 
999,北美洲其他国家(地区),44,广东省,21933664 ,1228403 ,23162067 
999,北美洲其他国家(地区),51,四川省,4157 ,82 ,4239 
999,博内尔,11,北京市,353 ,0 ,353 
999,博内尔,21,辽宁省,663 ,0 ,663 
999,博内尔,31,上海市,4509 ,91 ,4600 
999,博内尔,37,山东省,51 ,0 ,51 
999,博内尔,44,广东省,9707 ,51 ,9758 
999,大洋洲其他国家(地区),11,北京市,1290106 ,39369 ,1329475 
999,大洋洲其他国家(地区),12,天津市,12134082 ,0 ,12134082 
999,大洋洲其他国家(地区),13,河北省,9567086 ,0 ,9567086 
999,大洋洲其他国家(地区),14,山西省,517544 ,0 ,517544 
999,大洋洲其他国家(地区),21,辽宁省,805915 ,1504 ,807419 
999,大洋洲其他国家(地区),23,黑龙江省,69455 ,0 ,69455 
999,大洋洲其他国家(地区),31,上海市,14883914 ,445054 ,15328968 
999,大洋洲其他国家(地区),32,江苏省,38201441 ,199090 ,38400531 
999,大洋洲其他国家(地区),33,浙江省,72877328 ,0 ,72877328 
999,大洋洲其他国家(地区),34,安徽省,16632712 ,2144 ,16634856 
999,大洋洲其他国家(地区),35,福建省,27604813 ,0 ,27604813 
999,大洋洲其他国家(地区),36,江西省,29662007 ,0 ,29662007 
999,大洋洲其他国家(地区),37,山东省,88332197 ,0 ,88332197 
999,大洋洲其他国家(地区),41,河南省,3576409 ,646 ,3577055 
999,大洋洲其他国家(地区),42,湖北省,17696111 ,0 ,17696111 
999,大洋洲其他国家(地区),43,湖南省,24952791 ,0 ,24952791 
999,大洋洲其他国家(地区),44,广东省,133052605 ,49573 ,133102178 
999,大洋洲其他国家(地区),45,广西壮族自治区,3378144 ,0 ,3378144 
999,大洋洲其他国家(地区),50,重庆市,4660889 ,0 ,4660889 
999,大洋洲其他国家(地区),51,四川省,4148176 ,132324 ,4280500 
999,大洋洲其他国家(地区),52,贵州省,1292 ,0 ,1292 
999,大洋洲其他国家(地区),53,云南省,8545209 ,0 ,8545209 
999,大洋洲其他国家(地区),61,陕西省,3426823 ,101 ,3426924 
999,大洋洲其他国家(地区),65,新疆维吾尔自治区,2552072 ,0 ,2552072 
999,非洲其他国家(地区),11,北京市,10171 ,21336 ,31507 
999,非洲其他国家(地区),12,天津市,263 ,0 ,263 
999,非洲其他国家(地区),13,河北省,258323 ,0 ,258323 
999,非洲其他国家(地区),31,上海市,167862 ,224796 ,392658 
999,非洲其他国家(地区),32,江苏省,220903 ,1842 ,222745 
999,非洲其他国家(地区),33,浙江省,2656350 ,0 ,2656350 
999,非洲其他国家(地区),34,安徽省,683012 ,0 ,683012 
999,非洲其他国家(地区),35,福建省,13 ,0 ,13 
999,非洲其他国家(地区),36,江西省,3593485 ,0 ,3593485 
999,非洲其他国家(地区),37,山东省,2100828 ,1026730 ,3127558 
999,非洲其他国家(地区),41,河南省,1602 ,0 ,1602 
999,非洲其他国家(地区),42,湖北省,949215 ,0 ,949215 
999,非洲其他国家(地区),43,湖南省,1300892 ,0 ,1300892 
999,非洲其他国家(地区),44,广东省,105721 ,953433 ,1059154 
999,非洲其他国家(地区),51,四川省,4626582 ,1069 ,4627651 
999,盖比群岛,44,广东省,44572 ,0 ,44572 
999,国(地)别不详,11,北京市,51858 ,1551075562 ,1551127420 
999,国(地)别不详,12,天津市,3289 ,120210277 ,120213566 
999,国(地)别不详,13,河北省,11523 ,4565 ,16088 
999,国(地)别不详,14,山西省,548 ,15868422 ,15868970 
999,国(地)别不详,15,内蒙古自治区,6583 ,10564160 ,10570743 
999,国(地)别不详,21,辽宁省,4386 ,177527113 ,177531499 
999,国(地)别不详,22,吉林省,1096 ,28458736 ,28459832 
999,国(地)别不详,23,黑龙江省,1645 ,40121846 ,40123491 
999,国(地)别不详,31,上海市,39408 ,898600749 ,898640157 
999,国(地)别不详,32,江苏省,6382 ,246411751 ,246418133 
999,国(地)别不详,33,浙江省,40447 ,398748469 ,398788916 
999,国(地)别不详,34,安徽省,5914 ,26077110 ,26083024 
999,国(地)别不详,35,福建省,12264 ,142704905 ,142717169 
999,国(地)别不详,36,江西省,1096 ,24720517 ,24721613 
999,国(地)别不详,37,山东省,6774 ,87303885 ,87310659 
999,国(地)别不详,41,河南省,9010 ,94400236 ,94409246 
999,国(地)别不详,42,湖北省,6266 ,42155868 ,42162134 
999,国(地)别不详,43,湖南省,4268 ,445302253 ,445306521 
999,国(地)别不详,44,广东省,319151 ,2186921197 ,2187240348 
999,国(地)别不详,45,广西壮族自治区,548 ,36311915 ,36312463 
999,国(地)别不详,46,海南省,0 ,14368396 ,14368396 
999,国(地)别不详,50,重庆市,1644 ,30217777 ,30219421 
999,国(地)别不详,51,四川省,21439 ,74091153 ,74112592 
999,国(地)别不详,52,贵州省,117 ,11715520 ,11715637 
999,国(地)别不详,53,云南省,6034 ,18750720 ,18756754 
999,国(地)别不详,54,西藏自治区,0 ,271680 ,271680 
999,国(地)别不详,61,陕西省,1096 ,26483813 ,26484909 
999,国(地)别不详,62,甘肃省,548 ,0 ,548 
999,国(地)别不详,65,新疆维吾尔自治区,0 ,4127040 ,4127040 
999,荷属安地列斯,11,北京市,95703 ,5849 ,101552 
999,荷属安地列斯,12,天津市,1670632 ,0 ,1670632 
999,荷属安地列斯,13,河北省,2203737 ,0 ,2203737 
999,荷属安地列斯,14,山西省,9966 ,0 ,9966 
999,荷属安地列斯,21,辽宁省,11046 ,0 ,11046 
999,荷属安地列斯,31,上海市,3850631 ,0 ,3850631 
999,荷属安地列斯,32,江苏省,12990813 ,33185 ,13023998 
999,荷属安地列斯,33,浙江省,7025648 ,0 ,7025648 
999,荷属安地列斯,34,安徽省,1916402 ,0 ,1916402 
999,荷属安地列斯,35,福建省,4527491 ,0 ,4527491 
999,荷属安地列斯,36,江西省,3063839 ,0 ,3063839 
999,荷属安地列斯,37,山东省,16432610 ,0 ,16432610 
999,荷属安地列斯,41,河南省,2890045 ,0 ,2890045 
999,荷属安地列斯,42,湖北省,3105351 ,0 ,3105351 
999,荷属安地列斯,43,湖南省,1986672 ,0 ,1986672 
999,荷属安地列斯,44,广东省,47560150 ,807 ,47560957 
999,荷属安地列斯,45,广西壮族自治区,8381246 ,0 ,8381246 
999,荷属安地列斯,46,海南省,301913 ,0 ,301913 
999,荷属安地列斯,50,重庆市,48622 ,0 ,48622 
999,荷属安地列斯,51,四川省,1701708 ,0 ,1701708 
999,荷属安地列斯,61,陕西省,39 ,0 ,39 
999,加那利群岛,11,北京市,206821 ,255 ,207076 
999,加那利群岛,12,天津市,46166 ,0 ,46166 
999,加那利群岛,13,河北省,19771 ,0 ,19771 
999,加那利群岛,14,山西省,795 ,0 ,795 
999,加那利群岛,21,辽宁省,10678 ,0 ,10678 
999,加那利群岛,31,上海市,758245 ,9323 ,767568 
999,加那利群岛,32,江苏省,244950 ,171 ,245121 
999,加那利群岛,33,浙江省,914526 ,1183 ,915709 
999,加那利群岛,34,安徽省,87 ,404 ,491 
999,加那利群岛,35,福建省,760546 ,300 ,760846 
999,加那利群岛,36,江西省,19596 ,0 ,19596 
999,加那利群岛,37,山东省,2929200 ,135 ,2929335 
999,加那利群岛,41,河南省,4189 ,2903 ,7092 
999,加那利群岛,42,湖北省,149520 ,0 ,149520 
999,加那利群岛,43,湖南省,71229 ,0 ,71229 
999,加那利群岛,44,广东省,5211648 ,10816 ,5222464 
999,加那利群岛,50,重庆市,670 ,0 ,670 
999,加那利群岛,51,四川省,34438 ,0 ,34438 
999,加那利群岛,61,陕西省,11146 ,0 ,11146 
999,库腊索岛,11,北京市,238321 ,68 ,238389 
999,库腊索岛,12,天津市,4107724 ,0 ,4107724 
999,库腊索岛,13,河北省,8381273 ,0 ,8381273 
999,库腊索岛,21,辽宁省,2628129 ,0 ,2628129 
999,库腊索岛,23,黑龙江省,118563 ,0 ,118563 
999,库腊索岛,31,上海市,20158388 ,14078 ,20172466 
999,库腊索岛,32,江苏省,16695469 ,203 ,16695672 
999,库腊索岛,33,浙江省,35332031 ,39 ,35332070 
999,库腊索岛,34,安徽省,14314615 ,0 ,14314615 
999,库腊索岛,35,福建省,10160524 ,66 ,10160590 
999,库腊索岛,36,江西省,13801980 ,0 ,13801980 
999,库腊索岛,37,山东省,16333506 ,832 ,16334338 
999,库腊索岛,41,河南省,4485077 ,0 ,4485077 
999,库腊索岛,42,湖北省,1940397 ,0 ,1940397 
999,库腊索岛,43,湖南省,5267034 ,0 ,5267034 
999,库腊索岛,44,广东省,115663749 ,21822 ,115685571 
999,库腊索岛,45,广西壮族自治区,7859570 ,0 ,7859570 
999,库腊索岛,50,重庆市,3055015 ,0 ,3055015 
999,库腊索岛,51,四川省,792550 ,0 ,792550 
999,库腊索岛,53,云南省,1212377 ,0 ,1212377 
999,库腊索岛,61,陕西省,183284 ,0 ,183284 
999,拉丁美洲其他国家(地区),11,北京市,261414 ,32168 ,293582 
999,拉丁美洲其他国家(地区),12,天津市,1865 ,0 ,1865 
999,拉丁美洲其他国家(地区),13,河北省,111033 ,0 ,111033 
999,拉丁美洲其他国家(地区),15,内蒙古自治区,3072 ,0 ,3072 
999,拉丁美洲其他国家(地区),21,辽宁省,9888 ,216 ,10104 
999,拉丁美洲其他国家(地区),31,上海市,490967 ,298999 ,789966 
999,拉丁美洲其他国家(地区),32,江苏省,5056270 ,1082739 ,6139009 
999,拉丁美洲其他国家(地区),33,浙江省,8654111 ,56200 ,8710311 
999,拉丁美洲其他国家(地区),34,安徽省,13753017 ,0 ,13753017 
999,拉丁美洲其他国家(地区),35,福建省,2956208 ,0 ,2956208 
999,拉丁美洲其他国家(地区),36,江西省,513925 ,0 ,513925 
999,拉丁美洲其他国家(地区),37,山东省,10309050 ,0 ,10309050 
999,拉丁美洲其他国家(地区),41,河南省,4427305 ,0 ,4427305 
999,拉丁美洲其他国家(地区),42,湖北省,216976 ,20097 ,237073 
999,拉丁美洲其他国家(地区),43,湖南省,10444472 ,0 ,10444472 
999,拉丁美洲其他国家(地区),44,广东省,23142388 ,28673 ,23171061 
999,拉丁美洲其他国家(地区),45,广西壮族自治区,1019199 ,0 ,1019199 
999,拉丁美洲其他国家(地区),50,重庆市,25867 ,0 ,25867 
999,拉丁美洲其他国家(地区),51,四川省,379282 ,9796 ,389078 
999,拉丁美洲其他国家(地区),52,贵州省,351 ,0 ,351 
999,拉丁美洲其他国家(地区),53,云南省,635058 ,0 ,635058 
999,拉丁美洲其他国家(地区),61,陕西省,637 ,0 ,637 
999,联合国及机构和国际组织,44,广东省,1119 ,0 ,1119 
999,马克萨斯群岛,34,安徽省,47318 ,0 ,47318 
999,马克萨斯群岛,44,广东省,1898 ,0 ,1898 
999,梅利利亚,33,浙江省,128719 ,0 ,128719 
999,梅利利亚,44,广东省,9079 ,2735 ,11814 
999,欧洲其他国家(地区),11,北京市,2590551 ,5242 ,2595793 
999,欧洲其他国家(地区),12,天津市,336940 ,0 ,336940 
999,欧洲其他国家(地区),13,河北省,271600 ,0 ,271600 
999,欧洲其他国家(地区),31,上海市,5170792 ,10929 ,5181721 
999,欧洲其他国家(地区),32,江苏省,16188942 ,0 ,16188942 
999,欧洲其他国家(地区),33,浙江省,32097984 ,2974 ,32100958 
999,欧洲其他国家(地区),34,安徽省,1023374 ,0 ,1023374 
999,欧洲其他国家(地区),35,福建省,0 ,2383 ,2383 
999,欧洲其他国家(地区),36,江西省,15857 ,0 ,15857 
999,欧洲其他国家(地区),37,山东省,2275036 ,0 ,2275036 
999,欧洲其他国家(地区),41,河南省,285646 ,0 ,285646 
999,欧洲其他国家(地区),42,湖北省,12793 ,0 ,12793 
999,欧洲其他国家(地区),43,湖南省,1007197 ,0 ,1007197 
999,欧洲其他国家(地区),44,广东省,23600199 ,25476 ,23625675 
999,欧洲其他国家(地区),50,重庆市,8708 ,0 ,8708 
999,欧洲其他国家(地区),51,四川省,10281 ,0 ,10281 
999,萨巴,44,广东省,34910 ,0 ,34910 
999,塞卜泰(休达),12,天津市,0 ,1000 ,1000 
999,塞卜泰(休达),13,河北省,55 ,0 ,55 
999,塞卜泰(休达),31,上海市,0 ,290 ,290 
999,塞卜泰(休达),32,江苏省,413910 ,7884 ,421794 
999,塞卜泰(休达),33,浙江省,0 ,10735 ,10735 
999,塞卜泰(休达),34,安徽省,0 ,3980 ,3980 
999,塞卜泰(休达),42,湖北省,96 ,0 ,96 
999,塞卜泰(休达),44,广东省,32799 ,308 ,33107 
999,社会群岛,13,河北省,19758 ,0 ,19758 
999,社会群岛,31,上海市,59176 ,0 ,59176 
999,社会群岛,32,江苏省,1021714 ,0 ,1021714 
999,社会群岛,33,浙江省,166407 ,0 ,166407 
999,社会群岛,44,广东省,168 ,0 ,168 
999,社会群岛,46,海南省,846541 ,0 ,846541 
999,圣马丁岛,11,北京市,44501 ,0 ,44501 
999,圣马丁岛,12,天津市,20255 ,0 ,20255 
999,圣马丁岛,13,河北省,165496 ,0 ,165496 
999,圣马丁岛,14,山西省,3188 ,0 ,3188 
999,圣马丁岛,31,上海市,455138 ,432 ,455570 
999,圣马丁岛,32,江苏省,1829733 ,3765 ,1833498 
999,圣马丁岛,33,浙江省,6528969 ,0 ,6528969 
999,圣马丁岛,34,安徽省,762291 ,0 ,762291 
999,圣马丁岛,35,福建省,273560 ,0 ,273560 
999,圣马丁岛,36,江西省,1710504 ,0 ,1710504 
999,圣马丁岛,37,山东省,3104028 ,0 ,3104028 
999,圣马丁岛,41,河南省,295360 ,0 ,295360 
999,圣马丁岛,42,湖北省,58822 ,0 ,58822 
999,圣马丁岛,43,湖南省,154617 ,0 ,154617 
999,圣马丁岛,44,广东省,4772362 ,172 ,4772534 
999,圣马丁岛,45,广西壮族自治区,627295 ,0 ,627295 
999,圣马丁岛,50,重庆市,6043 ,0 ,6043 
999,圣马丁岛,51,四川省,1909983 ,0 ,1909983 
999,圣其茨和尼维斯,11,北京市,3686743 ,7540 ,3694283 
999,圣其茨和尼维斯,12,天津市,55519 ,2642553 ,2698072 
999,圣其茨和尼维斯,13,河北省,1074930 ,0 ,1074930 
999,圣其茨和尼维斯,21,辽宁省,15218 ,0 ,15218 
999,圣其茨和尼维斯,23,黑龙江省,16204 ,0 ,16204 
999,圣其茨和尼维斯,31,上海市,2443817 ,25162 ,2468979 
999,圣其茨和尼维斯,32,江苏省,8946856 ,429286 ,9376142 
999,圣其茨和尼维斯,33,浙江省,29110546 ,0 ,29110546 
999,圣其茨和尼维斯,34,安徽省,1291584 ,0 ,1291584 
999,圣其茨和尼维斯,35,福建省,70748 ,0 ,70748 
999,圣其茨和尼维斯,36,江西省,2930523 ,0 ,2930523 
999,圣其茨和尼维斯,37,山东省,13911239 ,3703 ,13914942 
999,圣其茨和尼维斯,41,河南省,62669 ,0 ,62669 
999,圣其茨和尼维斯,42,湖北省,497573 ,0 ,497573 
999,圣其茨和尼维斯,43,湖南省,1130439 ,0 ,1130439 
999,圣其茨和尼维斯,44,广东省,8962557 ,68847 ,9031404 
999,圣其茨和尼维斯,45,广西壮族自治区,295134 ,0 ,295134 
999,圣其茨和尼维斯,50,重庆市,1336904 ,0 ,1336904 
999,圣其茨和尼维斯,51,四川省,757239 ,0 ,757239 
999,土阿莫土群岛,44,广东省,10179 ,0 ,10179 
999,瓦利斯和浮图纳,11,北京市,541770 ,0 ,541770 
999,瓦利斯和浮图纳,12,天津市,553491 ,0 ,553491 
999,瓦利斯和浮图纳,13,河北省,351800 ,0 ,351800 
999,瓦利斯和浮图纳,21,辽宁省,48507 ,0 ,48507 
999,瓦利斯和浮图纳,31,上海市,73049 ,0 ,73049 
999,瓦利斯和浮图纳,32,江苏省,897480 ,8 ,897488 
999,瓦利斯和浮图纳,33,浙江省,1637249 ,0 ,1637249 
999,瓦利斯和浮图纳,34,安徽省,827144 ,0 ,827144 
999,瓦利斯和浮图纳,35,福建省,2070048 ,0 ,2070048 
999,瓦利斯和浮图纳,36,江西省,1417001 ,0 ,1417001 
999,瓦利斯和浮图纳,37,山东省,2327314 ,0 ,2327314 
999,瓦利斯和浮图纳,41,河南省,78 ,0 ,78 
999,瓦利斯和浮图纳,42,湖北省,78 ,0 ,78 
999,瓦利斯和浮图纳,43,湖南省,70857 ,0 ,70857 
999,瓦利斯和浮图纳,44,广东省,756671 ,938 ,757609 
999,瓦利斯和浮图纳,65,新疆维吾尔自治区,39 ,0 ,39 
999,亚洲其他国家(地区),31,上海市,424 ,0 ,424 
999,亚洲其他国家(地区),44,广东省,1062 ,605 ,1667 
999,中性包装原产国别,44,广东省,5552 ,0 ,5552 